# 0.  = 𐌰 𐌰̈ 𐌱 𐌲 𐌲̈ 𐌳 𐌴 𐌴̈ 𐌶 𐌷 𐌸 𐌹 𐌹̈ 𐌺 𐌺̈ 𐌻 𐌼 𐌽 𐌾 𐌿 𐌿̈ 𐍀 𐍁 𐍂 𐍃 𐍃̈ 𐍄 𐍅 𐍅̈ 𐍆 𐍆̔ 𐍇 𐍈 𐍉 𐍉̈ ¬
abbit = 𐌰𐌱𐌱𐌹𐍄
ablazed = 𐌰𐌱𐌻𐌴𐌹𐌶𐌳
ablaze = 𐌰𐌱𐌻𐌴𐌹𐌶
ache = 𐌴𐌹𐌺
achine = 𐌰𐍃̈𐌹𐌽
ac = 𐌰𐌺
afrai = 𐌰𐍆𐍂𐌴𐌹
aggrievedly = 𐌰𐌲𐍂𐌴̈𐍅̈𐌳𐌻𐌹
aggrieved = 𐌰𐌲𐍂𐌴̈𐍅̈𐌳
aggrieves = 𐌰𐌲𐍂𐌴̈𐍅̈𐌶
aggrieve = 𐌰𐌲𐍂𐌴̈𐍅̈
aggrieving = 𐌰𐌲𐍂𐌴̈𐍅̈𐌹𐌽𐌲
agician = 𐌰𐌲̈𐌹𐍇𐌹𐌰𐌽
agic = 𐌰𐌲̈𐌹𐌺
ago = 𐌰𐌲𐍉𐌿
agreed = 𐌰𐌲𐍂𐌴̈𐌳
agreement = 𐌰𐌲𐍂𐌴̈𐌼𐌴𐌽𐍄
agree = 𐌰𐌲𐍂𐌴̈
ain = 𐌴𐌹𐌽
airing = 𐌴𐌹𐍂
’air = ’𐌴𐌹𐍂
air = 𐌴𐌹𐍂
’alf = ’𐌰𐍆
alive = 𐌰𐌻𐌰𐌹𐍆̔
alleon = 𐌰𐌻𐌴𐍉𐌽
alloon = 𐌰𐌻𐌿𐌽
allop = 𐌰𐌻𐍉𐍀
all’s = 𐍉𐌻’𐌶
almost = 𐍉𐌻𐌼𐍉𐌿𐍃𐍄
alone = 𐌰𐌻𐍉𐌿𐌽
alors = 𐌰𐌻𐍉𐍂𐌶
alor = 𐌰𐌻𐍉𐍂
althoug = 𐍉𐌻𐌸𐍉𐌿
altogether = 𐍉𐌻𐍄𐌿𐌲𐌴𐌸𐌴𐍂
alvays = 𐍉𐌻𐍅̈𐌴𐌹𐌶
amazement = 𐌰𐌼𐌴𐌹𐌶𐌼𐌴𐌽𐍄
amaze = 𐌰𐌼𐌴𐌹𐌶
amazing = 𐌰𐌼𐌴𐌹𐌶𐌹𐌽𐌲
angerous = 𐌰𐌽𐌲̈𐌴𐍂𐍉𐍃
’ang = ’𐌰𐌽𐌲
annonball = 𐌰𐌽𐍉𐌽𐌱𐍉𐌻
answered = 𐌰𐌽𐍃𐌴𐍂𐌳
answering = 𐌰𐌽𐍃𐌴𐍂𐌹𐌽𐌲
answers = 𐌰𐌽𐍃𐌴𐍂𐌶
answer = 𐌰𐌽𐍃𐌴𐍂
apiece = 𐌰𐍀𐌴̈𐍇
appealed = 𐌰𐍀𐌴̈𐌻𐌳
appearance = 𐌰𐍀𐌴̈𐍂𐌰𐌽𐍇
appeared = 𐌰𐍀𐌴̈𐍂𐌳
appearing = 𐌰𐍀𐌴̈𐍂𐌹𐌽𐌲
appears = 𐌰𐍀𐌴̈𐍂𐌶
appear = 𐌰𐍀𐌴̈𐍂
appened = 𐌰𐍀𐌴𐌽𐌳
approached = 𐌰𐍀𐍂𐍉̈𐌺̈𐍄
approaches = 𐌰𐍀𐍂𐍉̈𐌺̈𐌴𐌶
approaching = 𐌰𐍀𐍂𐍉̈𐌺̈𐌹𐌽𐌲
approach = 𐌰𐍀𐍂𐍉̈𐌺̈
aquarium = 𐌰𐌺𐍅𐌰̈𐍂𐌹𐌿𐌼
area = 𐌰̈𐍂𐌴𐌰
aren’t = 𐌰𐍂’𐌽𐍄
arge = 𐌰𐍂𐌲̈
arise = 𐌰𐍂𐌰𐌹𐌶
aristocracy = 𐌰̈𐍂𐌹𐍃𐍄𐍉𐌺𐍂𐌰𐍇𐌹
’arrow = ’𐌰𐍂𐍉𐌿
ashamed = 𐌰𐍃̈𐌴𐌹𐌼𐌳
’asn’t = ’𐌰𐌶’𐌽𐍄
asn’t = 𐌰𐌶’𐌽𐍄
assured = 𐌰𐍃̈𐌿𐍂𐌳
assure = 𐌰𐍃̈𐌿𐍂
’as = ’𐌰𐌶
atch = 𐌰𐌺̈
atisfied = 𐌰𐍄𐌹𐍃𐍆𐌰𐌹𐌳
’ats = ’𐌰𐍄𐍃
atuous = 𐌰𐍄𐌿̈𐍉𐍃
aunts = 𐍁𐌿𐌽𐍄𐍃
aunt = 𐍁𐌿𐌽𐍄
avait = 𐌰𐍅̈𐌴𐌹𐍄
’aven’t = ’𐌰𐍆̔’𐌽𐍄
aven’t = 𐌰𐍆̔’𐌽𐍄
av = 𐌰𐍆̔
awake = 𐌰𐍅𐌴𐌹𐌺
aware = 𐌰𐍅𐌴𐌹𐍂
ays = 𐌴𐌶
a = 𐌰
babe = 𐌱𐌴𐌹𐌱
babies = 𐌱𐌴𐌹𐌱𐌹𐌶
baby = 𐌱𐌴𐌹𐌱𐌹
baked = 𐌱𐌴𐌹𐌺𐍄
bake = 𐌱𐌴𐌹𐌺
bake = 𐌱𐌴𐌹𐌺
baking = 𐌱𐌴𐌹𐌺𐌹𐌽𐌲
barring = 𐌱𐌰𐍂𐍂𐌹𐌽𐌲
bathing = 𐌱𐌴𐌹𐌸𐌹𐌽𐌲
beach = 𐌱𐌹𐌹𐌺̈
beasts = 𐌱𐌴̈𐍃𐍄𐍃
beast = 𐌱𐌴̈𐍃𐍄
became = 𐌱𐌴𐌺𐌴𐌹𐌼
beehive = 𐌱𐌴̈𐌷𐌰𐌹𐍅̈
been = 𐌱𐌹𐌹𐌽
bee = 𐌱𐌴̈
behaved = 𐌱𐌴𐌷𐌴𐌹𐍆̔𐌳
behaves = 𐌱𐌴𐌷𐌴𐌹𐍆̔𐌶
behave = 𐌱𐌴𐌷𐌴𐌹𐍆̔
behaving = 𐌱𐌴𐌷𐌴𐌹𐍆̔𐌹𐌽𐌲
behind = 𐌱𐌴𐌷𐌰𐌹𐌽𐌳
behin = 𐌱𐌴𐌷𐌰𐌹𐌽
beijing’s = 𐌱𐌴𐌹𐌲̈𐌹𐌽𐌲’𐍃
beijing = 𐌱𐌴𐌹𐌲̈𐌹𐌽𐌲
beings = 𐌱𐌹𐌹𐌽𐌲𐌶
being = 𐌱𐌹𐌹𐌽𐌲
believe = 𐌱𐌴𐌻𐌹𐌹𐍆̔
bellig = 𐌱𐌴𐌻𐌹𐌲̈
besides = 𐌱𐌴𐍃𐌰𐌹𐌳𐌶
beside = 𐌱𐌴𐍃𐌰𐌹𐌳
beyond = 𐌱𐌴¬𐌾𐍉𐌽𐌳
be = 𐌱𐌹
bind = 𐌱𐌰𐌹𐌽𐌳
bite = 𐌱𐌰𐌹𐍄
biting = 𐌱𐌰𐌹𐍄𐌹𐌽𐌲
blades = 𐌱𐌻𐌴𐌹𐌳𐌶
blade = 𐌱𐌻𐌴𐌹𐌳
blimey = 𐌱𐌻𐌰𐌹𐌼𐌹
bluebottle = 𐌱𐌻𐌴𐌿𐌱𐍉𐍄𐌴𐌻
blue = 𐌱𐌻𐌴𐌿
bolted = 𐌱𐍉𐌻𐍄𐌴𐌳
bolts = 𐌱𐍉𐌻𐍄𐍃
bolt = 𐌱𐍉𐌻𐍄
bone = 𐌱𐍉𐌿𐌽
bonfire = 𐌱𐍉𐌽¬𐍆𐌰𐌹𐍂
both = 𐌱𐍉𐌿𐌸
bow1 = 𐌱𐍉𐌿
bow2 = 𐌱𐌰𐌿
bow = 𐌱𐌰𐌿
boxes = 𐌱𐍉𐌺𐍃𐌴𐌶
box = 𐌱𐍉𐌺𐍃
brakes = 𐌱𐍂𐌴𐌹𐌺𐍃
brake = 𐌱𐍂𐌴𐌹𐌺
break = 𐌱𐍂𐌴𐌹𐌺
brett’s = 𐌱𐍂𐌴𐍄’𐍃
brett = 𐌱𐍂𐌴𐍄
broken = 𐌱𐍂𐍉𐌿𐌺𐌴𐌽
broke = 𐌱𐍂𐍉𐌿𐌺
bruised = 𐌱𐍂𐌿𐌶𐌳
bruises = 𐌱𐍂𐌿𐌶𐌴𐌶
bruise = 𐌱𐍂𐌿𐌶
bruising = 𐌱𐍂𐌿𐌶𐌹𐌽𐌲
bulgaria = 𐌱𐌿𐌻𐌲𐌰̈𐍂𐌹𐌰
bunsen = 𐌱𐍁𐌽𐍃𐌴𐌽
buys = 𐌱𐍁𐌹𐌶
buy = 𐌱𐍁𐌹
bye = 𐌱𐌰𐌹
by = 𐌱𐌰𐌹
b = 𐌱
cakes = 𐌺𐌴𐌹𐌺𐍃
cake = 𐌺𐌴𐌹𐌺
came = 𐌺𐌴𐌹𐌼
campaign = 𐌺𐌰𐌼𐍀𐌴𐌹𐌽
cannot = 𐌺𐌰𐌽𐌽𐍉𐍄
can’t = 𐌺𐌰’𐌽𐍄
carefully = 𐌺𐌴𐌹𐍂𐍆𐌿𐌻𐌻𐌹
careful = 𐌺𐌴𐌹𐍂𐍆𐌿𐌻
carelessly = 𐌺𐌴𐌹𐍂𐌻𐌴𐍃𐌻𐌹
careless = 𐌺𐌴𐌹𐍂𐌻𐌴𐍃
caretakers = 𐌺𐌴𐌹𐍂¬𐍄𐌴𐌹𐌺𐌴𐍂𐌶
caretaker = 𐌺𐌴𐌹𐍂¬𐍄𐌴𐌹𐌺𐌴𐍂
care = 𐌺𐌴𐌹𐍂
catc = 𐍇𐌰𐍄𐍇
ca = 𐌺𐌰
ccp’s = 𐍇𐌺𐍀’𐍃
ccp = 𐍇𐌺𐍀
ceased = 𐍇𐌴̈𐍃𐍄
ceases = 𐍇𐌴̈𐍃𐌴𐌶
cease = 𐍇𐌴̈𐍃
ceasing = 𐍇𐌴̈𐍃𐌹𐌽𐌲
ceos = 𐍇𐌴𐍉𐌶
charred = 𐌺̈𐌰𐍂𐌳
chased = 𐌺̈𐌰̈𐍇𐍄
chases = 𐌺̈𐌰̈𐍇𐌴𐌶
chase = 𐌺̈𐌰̈𐍇
chasing = 𐌺̈𐌰̈𐍇𐌹𐌽𐌲
chew = 𐌺̈𐌴𐌿
chief’s = 𐌺̈𐌴̈𐍆’𐍃
chiefs = 𐌺̈𐌴̈𐍆𐍃
chief = 𐌺̈𐌴̈𐍆
childhood = 𐌺̈𐌰𐌹𐌻𐌳𐌷𐌿𐌳
child = 𐌺̈𐌰𐌹𐌻𐌳
chinese = 𐌺̈𐌹̈𐌽𐌴̈𐌶
chocolate = 𐌺̈𐍉𐌺𐍉𐌻𐌰𐍄
choked = 𐌺̈𐍉𐌿𐌺𐍄
choke = 𐌺̈𐍉𐌿𐌺
choke = 𐌺̈𐍉𐌿𐌺
chosen = 𐌺̈𐍉𐌿𐌶𐌴𐌽
chose = 𐌺̈𐍉𐌿𐌶
cio = 𐌺𐌹𐍉
climbed = 𐌺𐌻𐌰𐌹𐌼𐌳
climbing = 𐌺𐌻𐌰𐌹𐌼𐌹𐌽𐌲
climb = 𐌺𐌻𐌰𐌹𐌼
close1 = 𐌺𐌻𐍉𐌿𐍃
close2 = 𐌺𐌻𐍉𐌿𐌶
closed = 𐌺𐌻𐍉𐌿𐌶𐌳
closely = 𐌺𐌻𐍉𐌿𐍃𐌻𐌹
closer = 𐌺𐌻𐍉𐌿𐍃𐌴𐍂
close = 𐌺𐌻𐍉𐌿𐌶
closing = 𐌺𐌻𐍉𐌿𐌶𐌹𐌽𐌲
clothes = 𐌺𐌻𐍉𐌿𐌸𐌶
clothing = 𐌺𐌻𐍉𐌿𐌸𐌹𐌽𐌲
coast = 𐌺𐍉̈𐍃𐍄
cockatrices = 𐌺𐍉𐌺𐌰𐍄𐍂𐌹𐍇𐌴𐌶
cockatrice = 𐌺𐍉𐌺𐌰𐍄𐍂𐌹𐍇
cocksure = 𐌺𐍉𐌺𐍃̈𐌿𐍂
comb = 𐌺𐍉𐌿𐌼
compare = 𐌺𐍉𐌼𐍀𐌰̈𐍂
concealed = 𐌺𐍉𐌽𐍇𐌴̈𐌻𐌳
conceal = 𐌺𐍉𐌽𐍇𐌴̈𐌻
copyrigh = 𐌺𐍉𐍀𐌹𐍂𐍁𐌹
cosy = 𐌺𐍉𐌿𐌶𐌹
couldn’t = 𐌺𐌿𐌳’𐌽𐍄
counterspy = 𐌺𐌰𐌿𐌽­𐍄𐌴𐍂𐍃­𐍀𐌹̈
countryside = 𐌺𐍁𐌽𐍄𐍂𐌹𐍃𐌰𐌹𐌳
’cours = ’𐌺𐍉̈𐍂𐍃
courtyard = 𐌺𐍉𐍂𐍄¬𐌾𐌰𐍂𐌳
coves = 𐌺𐍉𐌿𐍆̔𐌶
cove = 𐌺𐍉𐌿𐍆̔
coyote = 𐌺𐍉𐌾𐍉̈𐍄𐌴
cozy = 𐌺𐍉𐌿𐌶𐌹
co = 𐌺𐍁
cradles = 𐌺𐍂𐌴𐌹𐌳𐌴𐌻𐌶
cradle = 𐌺𐍂𐌴𐌹𐌳𐌴𐌻
created = 𐌺𐍂𐌴𐌰̈𐍄𐌴𐌳
creates = 𐌺𐍂𐌴𐌰̈𐍄𐍃
create = 𐌺𐍂𐌴𐌰̈𐍄
creating = 𐌺𐍂𐌴𐌰̈𐍄𐌹𐌽𐌲
creatures = 𐌺𐍂𐌴̈𐌰𐍄𐌿̈𐍂𐌶
creature = 𐌺𐍂𐌴̈𐌰𐍄𐌿̈𐍂
cried = 𐌺𐍂𐌰𐌹𐌳
cries = 𐌺𐍂𐌰𐌹𐌶
crowy = 𐌺𐍂𐍉𐌿𐌹
crumptious = 𐌺𐍂𐍁𐌼𐍀𐍇𐌹𐍉𐍃
crying = 𐌺𐍂𐌰𐌹𐌹𐌽𐌲
cry = 𐌺𐍂𐌰𐌹
ct = 𐌺𐍄
cumulus = 𐌺𐌿̈𐌼𐌿𐌻𐌿𐍃
cunnin = 𐌺𐍁𐌽𐌹𐌽
cupboard = 𐌺𐍁𐍀𐌱𐍉𐍂𐌳
c = 𐍇
dared = 𐌳𐌴𐌹𐍂𐌳
daresay = 𐌳𐌴𐌹𐍂𐍃𐌴𐌹
dares = 𐌳𐌴𐌹𐍂𐌶
dare = 𐌳𐌴𐌹𐍂
daring = 𐌳𐌴𐌹𐍂𐌹𐌽𐌲
daytime = 𐌳𐌴𐌹¬𐍄𐌰𐌹𐌼
dazed = 𐌳𐌰̈𐌶𐌳
dazes = 𐌳𐌰̈𐌶𐌴𐌶
daze = 𐌳𐌰̈𐌶
defeated = 𐌳𐌴𐍆𐌴̈𐍄𐌴𐌳
defeating = 𐌳𐌴𐍆𐌴̈𐍄𐌹𐌽𐌲
defeats = 𐌳𐌴𐍆𐌴̈𐍄𐍃
defeat = 𐌳𐌴𐍆𐌴̈𐍄
deirdre = 𐌳𐌹𐌹𐍂𐌳𐍂𐌴
dese = 𐌳𐌹𐌹𐌶
despiser’s = 𐌳𐌴𐍃𐍀𐌹̈𐌶𐌴𐍂’𐍃
des = 𐌳𐌴𐍃
de = 𐌳𐌹
diamonds = 𐌳𐌹̈𐌰𐌼𐍉𐌽𐌳𐌶
diamond = 𐌳𐌹̈𐌰𐌼𐍉𐌽𐌳
diamond = 𐌳𐌹̈𐌰𐌼𐍉𐌽𐌳
didn’t = 𐌳𐌹𐌳’𐌽𐍄
died = 𐌳𐌰𐌹𐌳
die = 𐌳𐌰𐌹
directions = 𐌳𐌹𐍂𐌴𐌺𐍇𐌹𐍉𐌽𐌶
disappeared = 𐌳𐌹𐍃𐌰𐍀𐌴̈𐍂𐌳
disappears = 𐌳𐌹𐍃𐌰𐍀𐌴̈𐍂𐌶
disappear = 𐌳𐌹𐍃𐌰𐍀𐌴̈𐍂
dived = 𐌳𐌰𐌹𐍆̔𐌳
dives = 𐌳𐌰𐌹𐍆̔𐌶
dive = 𐌳𐌰𐌹𐍆̔
diving = 𐌳𐌰𐌹𐍆̔𐌹𐌽𐌲
dna = 𐌳𐌽𐌰
doesn’t = 𐌳𐍁𐌶’𐌽𐍄
does = 𐌳𐍁𐌶
don’t = 𐌳𐍉’𐌽𐍄
dos = 𐌳𐌿𐌶
downsy = 𐌳𐌰𐌿𐌽𐍃𐌹
dozed = 𐌳𐍉𐌿𐌶𐌳
dozes = 𐌳𐍉𐌿𐌶𐌴𐌶
doze = 𐌳𐍉𐌿𐌶
dozing = 𐌳𐍉𐌿𐌶𐌹𐌽𐌲
dried = 𐌳𐍂𐌰𐌹𐌳
driver = 𐌳𐍂𐌰𐌹𐍆̔𐌴𐍂
drive = 𐌳𐍂𐌰𐌹𐍆̔
drove = 𐌳𐍂𐍉𐌿𐍆̔
dryly = 𐌳𐍂𐌰𐌹𐌻𐌹
dr = 𐌳𐍂
dulcibelle’s = 𐌳𐍁𐌻𐍇𐌹𐌱𐌴𐌻’𐍃
dulcibelle = 𐌳𐍁𐌻𐍇𐌹𐌱𐌴𐌻
dune = 𐌳𐌿̈𐌽
durrell = 𐌳𐍁𐍂𐌴𐌻
dying = 𐌳𐌰𐌹𐌹𐌽𐌲
d’you = 𐌳’𐌾𐌿
d = 𐌳
eadache = 𐌴𐌳𐌴𐌹𐌺
’ead = ’𐌴𐌳
’eard = ’𐌴𐍂𐌳
eartfelt = 𐌰𐍂𐍄𐍆𐌴𐌻𐍄
earthquakes = 𐍁𐍂𐌸𐌺𐍅𐌴𐌹𐌺𐍃
earthquake = 𐍁𐍂𐌸𐌺𐍅𐌴𐌹𐌺
’eart = ’𐌰𐍂𐍄
’ear = ’𐌹𐍂
eateth = 𐌹𐌹𐍄𐌴𐌸
eautiful = 𐌿̈𐍄𐌹𐍆𐌿𐌻
’eavy = ’𐌴𐍆̔𐌹
ecipe = 𐌴𐍇𐌹𐍀𐌴
ecluded = 𐌴𐌺𐌻𐌿𐌳𐌴𐌳
ecret = 𐌴̈𐌺𐍂𐌴𐍄
eetle = 𐌴̈𐍄𐌴𐌻
eez = 𐌹𐌹𐌶
eighth = 𐌴𐌾𐍄𐌸
eightieth = 𐌴𐌾𐍄𐍄𐌹𐌸
eighty = 𐌴𐌾𐍄𐍄𐌹
eight = 𐌴𐌾𐍄
either = 𐌹𐌸𐌴𐍂
elicious = 𐌴̈𐌻𐌹𐍇𐌾𐍉𐍃
’e’ll = ’𐌹’𐌻
’elp = ’𐌴𐌻𐍀
elp = 𐌴𐌻𐍀
emarkably = 𐌴𐌼𐌰𐍂𐌺𐌰𐌱𐌻𐌹
embarrassed = 𐌴𐌼𐌱𐌰𐍂𐌰𐍃𐍄
embarrasses = 𐌴𐌼𐌱𐌰𐍂𐌰𐍃𐌴𐌶
embarrassing = 𐌴𐌼𐌱𐌰𐍂𐌰𐍃𐌹𐌽𐌲
embarrassment = 𐌴𐌼𐌱𐌰𐍂𐌰𐍃𐌼𐌴𐌽𐍄
embarrass = 𐌴𐌼𐌱𐌰𐍂𐌰𐍃
employees = 𐌴𐌼𐍀𐌻𐍉𐌾𐌴̈𐌶
employee = 𐌴𐌼𐍀𐌻𐍉𐌾𐌴̈
enerally = 𐌴𐌽𐌴𐍂𐌰𐌻𐌹
’ere’s = ’𐌹𐍂’𐌶
’ere = ’𐌹𐍂
eriod = 𐌴̈𐍂𐌹𐍉𐌳
erious = 𐌴̈𐍂𐌹𐍉𐍃
errible = 𐌴𐍂𐌹𐌱𐌴𐌻
ertain = 𐍁𐍂𐍄𐌴𐌹𐌽
estaurant = 𐌴𐍃𐍄𐍁𐌿𐍂𐌰𐌽
est = 𐌴𐍃𐍄
es = 𐌴𐍃
’e’s = ’𐌹’𐌶
etamorphosis = 𐌴𐍄𐌰𐌼𐍉𐍂𐍆𐍉𐍃𐌹𐍃
evening = 𐌹𐍆̔𐌽𐌹𐌽𐌲
even = 𐌹𐍆̔𐌴𐌽
every = 𐌴𐍆̔𐍂𐌹
e’ve = 𐌹’𐍆̔
evil = 𐌹𐍆̔𐌹𐌻
exceeded = 𐌴𐌺𐍃𐍇𐌴̈𐌳𐌴𐌳
’exceedingly = ’𐌴𐌺𐍃𐍇𐌴̈𐌳𐌹𐌽𐌲𐌻𐌹
exceedingly = 𐌴𐌺𐍃𐍇𐌴̈𐌳𐌹𐌽𐌲𐌻𐌹
exceeding = 𐌴𐌺𐍃𐍇𐌴̈𐌳𐌹𐌽𐌲
exceeds = 𐌴𐌺𐍃𐍇𐌴̈𐌳𐌶
exceed = 𐌴𐌺𐍃𐍇𐌴̈𐌳
exclaimed = 𐌴𐌺𐍃𐌺𐌻𐌰̈𐌼𐌳
exclaiming = 𐌴𐌺𐍃𐌺𐌻𐌰̈𐌼𐌹𐌽𐌲
exclaims = 𐌴𐌺𐍃𐌺𐌻𐌰̈𐌼𐌶
exclaim = 𐌴𐌺𐍃𐌺𐌻𐌰̈𐌼
excuse2 = 𐌴𐌺𐍃𐌺𐌿̈𐌶
eyebrow = 𐍁𐌹𐌱𐍂𐌰𐌿
eyed = 𐍁𐌹𐌳
eyeing = 𐍁𐌹𐌹𐌽𐌲
eyelashes = 𐍁𐌹¬𐌻𐌰𐍃̈𐌴𐌶
eyelashe = 𐍁𐌹¬𐌻𐌰𐍃̈
eyelids = 𐍁𐌹¬𐌻𐌹𐌳𐌶
eyelid = 𐍁𐌹¬𐌻𐌹𐌳
eyesight = 𐍁𐌹𐍃𐍁𐌹𐍄
eyes = 𐍁𐌹𐌶
eye = 𐍁𐌹
’e = ’𐌹
fading = 𐍆𐌴𐌹𐌳𐌹𐌽𐌲
fair’s = 𐍆𐌴𐌹𐍂’𐌶
falling = 𐍆𐍉𐌻𐌹𐌽𐌲
farewell = 𐍆𐌴𐌹𐍂¬𐍅𐌴𐌻
fatly = 𐍆𐌰𐍄𐌻𐌹
fbi = 𐍆𐌱𐌹
fearfully = 𐍆𐌹𐍂¬𐍆𐌿𐌻𐌻𐌹
fiery = 𐍆𐌰𐌹𐍂𐌹
file = 𐍆𐌰𐌹𐌻
finding = 𐍆𐌰𐌹𐌽𐌳𐌹𐌽𐌲
find = 𐍆𐌰𐌹𐌽𐌳
firebreathing = 𐍆𐌰𐌹𐍂𐌱𐍂𐌹𐌹𐌸𐌹𐌽𐌲
firedrakes = 𐍆𐌰𐌹𐍂¬𐌳𐍂𐌴𐌹𐌺𐍃
firedrake = 𐍆𐌰𐌹𐍂¬𐌳𐍂𐌴𐌹𐌺
fired = 𐍆𐌰𐌹𐍂𐌳
fireflies = 𐍆𐌰𐌹𐍂𐍆𐌻𐌰𐌹𐌶
firefly = 𐍆𐌰𐌹𐍂𐍆𐌻𐌰𐌹
firelight = 𐍆𐌰𐌹𐍂¬𐌻𐍁𐌹𐍄
fireproof = 𐍆𐌰𐌹𐍂𐍀𐍂𐌿𐍆
fires = 𐍆𐌰𐌹𐍂𐌶
fireworks = 𐍆𐌰𐌹𐍂¬𐍅𐍁𐍂𐌺𐍃
firework = 𐍆𐌰𐌹𐍂¬𐍅𐍁𐍂𐌺
fire = 𐍆𐌰𐌹𐍂
firing = 𐍆𐌰𐌹𐍂𐌹𐌽𐌲
five = 𐍆𐌰𐌹𐍅̈
flashlights = 𐍆𐌻𐌰𐍃̈𐌻𐍁𐌹𐍄𐍃
flibberty = 𐍆𐌻𐌹𐌱𐌴𐍂𐍄𐌹
flying = 𐍆𐌻𐌰𐌹𐌹𐌽𐌲
folk = 𐍆𐍉𐌿𐌺
fooled = 𐍆𐌿𐌿𐌻𐌳
foolish = 𐍆𐌿𐌿𐌻𐌹𐍃̈
fools = 𐍆𐌿𐌿𐌻𐌶
fool = 𐍆𐌿𐌿𐌻
forty = 𐍆𐍉𐌿𐍂𐍄𐌹
fourteen = 𐍆𐍉𐌿𐍂¬𐍄𐌹𐌹𐌽
fourth = 𐍆𐍉𐌿𐍂𐌸
four = 𐍆𐍉𐌿𐍂
foxes = 𐍆𐍉𐌺𐍃𐌴𐌶
fox = 𐍆𐍉𐌺𐍃
frame = 𐍆𐍂𐌴𐌹𐌼
friday = 𐍆𐍂𐌰𐌹𐌳𐌴𐌹
froze = 𐍆𐍂𐍉𐌿𐌶
fro = 𐍆𐍂𐍉𐌿
furnitur = 𐍆𐌿𐍂𐌽𐌹𐍄𐌿̈𐍂
f = 𐍆
gamboled = 𐌲𐌰𐌼𐌱𐍉𐌻𐌳
game = 𐌲𐌴𐌹𐌼
gape = 𐌲𐌴𐌹𐍀
gaping = 𐌲𐌴𐌹𐍀𐌹𐌽𐌲
gates = 𐌲𐌴𐌹𐍄𐍃
gate = 𐌲𐌴𐌹𐍄
gate = 𐌲𐌴𐌹𐍄
gave = 𐌲𐌴𐌹𐍆̔
gazed = 𐌲𐌴𐌹𐌶𐌳
gaze = 𐌲𐌴𐌹𐌶
gazing = 𐌲𐌴𐌹𐌶𐌹𐌽𐌲
generally = 𐌲̈𐌴𐌽𐌴𐍂𐌰𐌻𐌻𐌹
ghost = 𐌲𐍉𐌿𐍃𐍄
gibberty = 𐌲𐌹𐌱𐌴𐍂𐍄𐌹
give = 𐌲𐌹𐍆̔
glared = 𐌲𐌻𐌴𐌹𐍂𐌳
glares = 𐌲𐌻𐌴𐌹𐍂𐌶
glare = 𐌲𐌻𐌴𐌹𐍂
glaring = 𐌲𐌻𐌴𐌹𐍂𐌹𐌽𐌲
glubbing = 𐌲𐌻𐍁𐌱𐌹𐌽𐌲
glup = 𐌲𐌻𐍁𐍀
goes = 𐌲𐍉𐌿𐌶
goeth = 𐌲𐍉𐌿𐌸
goings = 𐌲𐍉𐌿𐌹𐌽𐌲𐌶
going = 𐌲𐍉𐌿𐌹𐌽𐌲
goot = 𐌲𐌿𐍄
go = 𐌲𐍉𐌿
graduate = 𐌲𐍂𐌰𐌳𐌿̈𐌰𐍄
grave = 𐌲𐍂𐌴𐌹𐍆̔
graze = 𐌲𐍂𐌴𐌹𐌶
grazing = 𐌲𐍂𐌴𐌹𐌶𐌹𐌽𐌲
greece = 𐌲𐍂𐌴̈𐍇
greek = 𐌲𐍂𐌴̈𐌺
grew = 𐌲𐍂𐌴𐌿
growly = 𐌲𐍂𐍉𐌿𐌻𐌹
growt’s = 𐌲𐍂𐍉𐌿𐍄’𐍃
growt = 𐌲𐍂𐍉𐌿𐍄
gruesome = 𐌲𐍂𐌿𐍃𐍁𐌼
guys = 𐌲𐌹̈𐌶
guy = 𐌲𐌹̈
g = 𐌲
harry = 𐌷𐌰𐍂𐌹
haste = 𐌷𐌴𐌹𐍃𐍄
hastily = 𐌷𐌴𐌹𐍃𐍄𐌹𐌻𐌹
hate = 𐌷𐌴𐌹𐍄
haven’t = 𐌷𐌰𐍆̔’𐌽𐍄
have = 𐌷𐌰𐍆̔
hazel = 𐌷𐌴𐌹𐌶𐌴𐌻
haze = 𐌷𐌴𐌹𐌶
hearing = 𐌷𐌹𐌹𐍂𐌹𐌽𐌲
hears = 𐌷𐌹𐌹𐍂𐌶
hear = 𐌷𐌹𐌹𐍂
he’d = 𐌷𐌹’𐌳
hef’s = 𐌷𐌴𐍆’𐍃
he’ll = 𐌷𐌹’𐌻
here’s = 𐌷𐌹𐍂’𐌶
here = 𐌷𐌹𐍂
her = 𐌷𐍁𐍂
he’s = 𐌷𐌹’𐌶
he = 𐌷𐌹
hiccups = 𐌷𐌹𐌺𐍁𐍀𐍃
hiccup = 𐌷𐌹𐌺𐍁𐍀
hic = 𐌷𐌹𐌺
hide = 𐌷𐌰𐌹𐌳
hiding = 𐌷𐌰𐌹𐌳𐌹𐌽𐌲
hie = 𐌷𐌰𐌹
hillside = 𐌷𐌹𐌻𐍃𐌰𐌹𐌳
himble = 𐌷𐌹𐌼𐌱𐌴𐌻
hind = 𐌷𐌰𐌹𐌽𐌳
hire = 𐌷𐌰𐌹𐍂
hirl = 𐌷𐍁𐍂𐌻
hisself = 𐌷𐌹𐌶𐍃𐌴𐌻𐍆
hi = 𐌷𐌰𐌹
hoarse = 𐌷𐍉𐌿𐍂𐍃
hole = 𐌷𐍉̈𐌻
hole = 𐌷𐍉𐌿𐌻
holy = 𐌷𐍉𐌿𐌻𐌹
homeless = 𐌷𐍉𐌿𐌼𐌻𐌴𐍃
home = 𐌷𐍉𐌿𐌼
hopefully = 𐌷𐍉𐌿𐍀¬𐍆𐌿𐌻¬𐌻𐌹
hope = 𐌷𐍉𐌿𐍀
hoping = 𐌷𐍉𐌿𐍀𐌹𐌽𐌲
hortense’s = 𐌷𐍉𐍂𐍄𐌴𐌽𐍃’𐍃
hortense = 𐌷𐍉𐍂𐍄𐌴𐌽𐍃
hould = 𐌷𐍉𐌿𐌻𐌳
hours = 𐌰𐌿𐌴𐍂𐌶
hour = 𐌰𐌿𐌴𐍂
houseflies = 𐌷𐌰𐌿𐍃𐍆𐌻𐌰𐌹𐌶
housefly = 𐌷𐌰𐌿𐍃𐍆𐌻𐌰𐌹
houston = 𐌷𐌴𐌿𐍃𐍄𐍉𐌽
howed = 𐌷𐍉𐌿𐌳
how’s = 𐌷𐌰𐌿’𐌶
hows = 𐌷𐌰𐌿𐌶
hows = 𐌷𐍉𐌿𐌶
ho = 𐌷𐍉𐌿
huawei = 𐌷𐌿𐌰𐍅𐌴𐌹
hubei = 𐌷𐌿𐌱𐌴𐌹
hught’s = 𐌷𐌿𐌷𐍄’𐍃
hught = 𐌷𐌿𐌷𐍄
h = 𐌷
h’ = 𐌷’
iamond = 𐌹̈𐌰𐌼𐍉𐌽𐌳
ice = 𐌰𐌹𐍃
icing = 𐌰𐌹𐍃𐌹𐌽𐌲
ick = 𐌹𐌺
ictionary = 𐌹𐌺𐍇𐌹𐍉𐌽𐌰𐍂𐌹
ideous = 𐌹̈𐌳𐌴𐍉𐍃
idiculous = 𐌹𐌳𐌹𐌺𐌿̈𐌻𐍉𐍃
i’d = 𐌰𐌹’𐌳
iercing = 𐌴̈𐍂𐍇𐌹𐌽𐌲
ight = 𐌰𐌹𐍄
ii = 𐌹𐌹
ik = 𐌹𐌺
i’ll = 𐌰𐌹’𐌻
’ill = ’𐌹𐌻
i’m = 𐌰𐌹’𐌼
increased = 𐌹𐌽𐌺𐍂𐌴̈𐍃𐍄
increased = 𐌹𐌽𐌺𐍂𐌴̈𐍃𐍄
increases = 𐌹𐌽𐌺𐍂𐌴̈𐍃𐌴𐌶
increase = 𐌹𐌽𐌺𐍂𐌴̈𐍃
increasing = 𐌹𐌽𐌺𐍂𐌴̈𐍃𐌹𐌽𐌲
indeed = 𐌹𐌽𐌳𐌹𐌳
inside = 𐌹𐌽𐍃𐌰𐌹𐌳
insight = 𐌹𐌽𐍃𐍁𐌹𐍄
insurance = 𐌹𐌽𐍃̈𐌿𐍂𐌰𐌽𐍇
intertwinement = 𐌹𐌽𐍄𐌴𐍂𐍅𐌰𐌹𐌽𐌼𐌴𐌽𐍄
ion’s = 𐌾𐍉𐌽’𐌶
ipple = 𐌹𐍀𐌴𐌻
ippo’s = 𐌹𐍀𐍉’𐍃
ircle = 𐍁𐍂𐌺𐌴𐌻
ird = 𐍁𐍂𐌳
’ire = ’𐌰𐌹𐍂
’ire = ’𐌹̈𐍂
irl = 𐍁𐍂𐌻
irm = 𐍁𐍂𐌼
ironing = 𐌰𐌹𐍂𐍉𐌽𐌹𐌽𐌲
iron = 𐌰𐌹𐍂𐍉𐌽
iron = 𐌰𐌹𐍂𐍉𐌽
irror = 𐌹𐍂𐍉𐍂
irst = 𐍁𐍂𐍃𐍄
isbn = 𐌹𐍃𐌱𐌽
islands = 𐌰𐌹𐌻𐌰𐌽𐌳𐌶
island = 𐌰𐌹𐌻𐌰𐌽𐌳
issed = 𐌹𐍃𐍄
’is = ’𐌹𐌶
ithuanian = 𐌹𐌸𐌿𐌰̈𐌽𐌹𐌰𐌽
it’s = 𐌹𐍄’𐌶
ittle = 𐌹𐍄𐌴𐌻
ity = 𐌹𐍄𐌹
i’ve = 𐌰𐌹’𐍆̔
i = 𐌰𐌹
jaipur = 𐌲̈𐌰𐌹𐍀𐌿𐍂
ja = 𐌲̈𐌰
jiechi = 𐌲̈𐌹𐌴𐌺̈𐌹
jinping = 𐌲̈𐌹𐌽𐍀𐌹𐌽𐌲
jpg = 𐌲̈𐍀𐌲
j = 𐌲̈
katmandu = 𐌺𐌰𐍄𐌼𐌰𐌽𐌳𐌿
keyboard = 𐌺𐌹𐌹𐌱𐍉𐍂𐌳
keys = 𐌺𐌹𐌹𐌶
key = 𐌺𐌹𐌹
kindest = 𐌺𐌰𐌹𐌽𐌳𐌴𐍃𐍄
kindly = 𐌺𐌰𐌹𐌽𐌳𐌻𐌹
kindness = 𐌺𐌰𐌹𐌽𐌳¬𐌽𐌴𐍃
kind = 𐌺𐌰𐌹𐌽𐌳
knife = 𐌺𐌽𐌰𐌹𐍆
knives = 𐌺𐌽𐌰𐌹𐍆̔𐌶
kno = 𐌺𐌽𐍉
k = 𐌺
laden = 𐌻𐌴𐌹𐌳𐌴𐌽
ladies = 𐌻𐌴𐌹𐌳𐌹𐌶
ladles = 𐌻𐌴𐌹𐌳𐌴𐌻𐌶
ladle = 𐌻𐌴𐌹𐌳𐌴𐌻
lady = 𐌻𐌴𐌹𐌳𐌹
lakes = 𐌻𐌴𐌹𐌺𐍃
lake = 𐌻𐌴𐌹𐌺
landscape = 𐌻𐌰𐌽𐌳𐍃𐌺𐌴𐌹𐍀
later = 𐌻𐌴𐌹𐍄𐌴𐍂
latest = 𐌻𐌴𐌹𐍄𐌴𐍃𐍄
late = 𐌻𐌴𐌹𐍄
lazy = 𐌻𐌴𐌹𐌶𐌹
lead1 = 𐌻𐌴𐌳
lead = 𐌻𐌹𐌹𐌳
leagues = 𐌻𐌴̈𐌲𐌶
league = 𐌻𐌴̈𐌲
leant = 𐌻𐌹𐌹𐌽𐍄
leetle = 𐌻𐌹𐌹𐍄𐌴𐌻
lied = 𐌻𐌰𐌹𐌳
lies = 𐌻𐌰𐌹𐌶
lie = 𐌻𐌰𐌹
lifelike = 𐌻𐌰𐌹𐍆¬𐌻𐌰𐌹𐌺
lifetime = 𐌻𐌰𐌹𐍆𐍄𐌰𐌹𐌼
life = 𐌻𐌰𐌹𐍆
lif = 𐌻𐌹𐍆
ligh = 𐌻𐌰𐌹
likeable = 𐌻𐌰𐌹𐌺𐌰𐌱𐌴𐌻
liked = 𐌻𐌰𐌹𐌺𐍄
likely = 𐌻𐌰𐌹𐌺𐌻𐌹
likes = 𐌻𐌰𐌹𐌺𐍃
likewise = 𐌻𐌰𐌹𐌺𐍅𐌰𐌹𐌶
like = 𐌻𐌰𐌹𐌺
lik = 𐌻𐌹𐌺
live1 = 𐌻𐌰𐌹𐍆̔
live2 = 𐌻𐌹𐍆̔
lived = 𐌻𐌹𐍆̔𐌳
liven = 𐌻𐌰𐌹𐍆̔𐌴𐌽
lives1 = 𐌻𐌰𐌹𐍆̔𐌶
live = 𐌻𐌰𐌹𐍆̔
ll = 𐌻
lonely = 𐌻𐍉𐌿𐌽𐌻𐌹
lopsidedly = 𐌻𐍉𐍀𐍃𐌰𐌹𐌳𐌴𐌳𐌻𐌹
lo = 𐌻𐍉𐌿
lready = 𐌻𐍂𐌴𐌳𐌹
lungfuls = 𐌻𐍁𐌽𐌲𐍆𐌿𐌻𐌶
lurketh = 𐌻𐍁𐍂𐌺𐌸
lways = 𐌻𐍅𐌴𐌹𐌶
lying = 𐌻𐌰𐌹𐌹𐌽𐌲
l = 𐌻
madeira = 𐌼𐌰𐌳𐌴̈𐍂𐌰
made = 𐌼𐌴𐌹𐌳
maharaja = 𐌼𐌰𐌷𐌰𐍂𐌰𐌲̈𐌰
makes = 𐌼𐌴𐌹𐌺𐍃
makeup = 𐌼𐌴𐌹𐌺¬𐍁𐍀
make = 𐌼𐌴𐌹𐌺
making = 𐌼𐌴𐌹𐌺𐌹𐌽𐌲
mandrakes = 𐌼𐌰𐌽𐌳𐍂𐌴𐌹𐌺𐍃
mandrake = 𐌼𐌰𐌽𐌳𐍂𐌴𐌹𐌺
mane = 𐌼𐌰̈𐌽
mao = 𐌼𐌰𐍉
marijuana = 𐌼𐌰𐍂𐌹𐌷𐌿𐌰𐌽𐌰
marriages = 𐌼𐌰𐍂𐌹𐌰𐌲̈𐌴𐌶
marriage = 𐌼𐌰𐍂𐌹𐌰𐌲̈
mastermind = 𐌼𐌰𐍃𐍄𐌴𐍂𐌼𐌰𐌹𐌽𐌳
maybe = 𐌼𐌴𐌹𐌱𐌹
maze = 𐌼𐌴𐌹𐌶
meantime = 𐌼𐌹𐌹𐌽𐍄𐌰𐌹𐌼
meanwhile = 𐌼𐌹𐌹𐌽𐍅𐌰𐌹𐌻
measures = 𐌼𐌴𐌶𐌿̈𐍂𐌶
measure = 𐌼𐌴𐌶𐌿̈𐍂
meet = 𐌼𐌹𐌹𐍄
merely = 𐌼𐌹𐍂𐌻𐌹
mere = 𐌼𐌹𐍂
meringues = 𐌼𐌴𐍂𐌰𐌽𐌲𐌶
meringue = 𐌼𐌴𐍂𐌰𐌽𐌲
me = 𐌼𐌹
mhoram = 𐌼𐌷𐍉𐍂𐌰𐌼
mice = 𐌼𐌰𐌹𐍃
michael = 𐌼𐌹̈𐌺𐌴𐌻
midnight = 𐌼𐌹𐌳𐌽𐍁𐌹𐍄
minded = 𐌼𐌰𐌹𐌽𐌳𐌴𐌳
mind = 𐌼𐌰𐌹𐌽𐌳
mine2 = 𐌼𐌹̈𐌽
mine = 𐌼𐌰𐌹𐌽
misshapen = 𐌼𐌹𐍃¬𐍃̈𐌴𐌹𐍀𐌴𐌽
mistaken = 𐌼𐌹𐍃¬𐍄𐌴𐌹𐌺𐌴𐌽
mistakes = 𐌼𐌹𐍃¬𐍄𐌴𐌹𐌺𐍃
mistake = 𐌼𐌹𐍃¬𐍄𐌴𐌹𐌺
moonlight = 𐌼𐌿𐌽𐌻𐍁𐌹𐍄
moonrise = 𐌼𐌿𐌽¬𐍂𐌰𐌹𐌶
mooooooo = 𐌼𐌿𐌿𐌿𐌿𐌿𐌿
mooooo = 𐌼𐌿𐌿𐌿𐌿
mortifie = 𐌼𐍉𐍂𐍄𐌹𐍆𐌹̈
most = 𐌼𐍉𐌿𐍃𐍄
mountainside = 𐌼𐌰𐌿𐌽𐍄𐌴𐌽𐍃𐌰𐌹𐌳
mouths1 = 𐌼𐌰𐌿𐌸𐍃
mouths2 = 𐌼𐌰𐌿𐌸𐌶
mouths = 𐌼𐌰𐌿𐌸𐍃
mouth = 𐌼𐌰𐌿𐌸
mr = 𐌼𐍂
must’ve = 𐌼𐍁𐍃𐍄’𐍆̔
myself = 𐌼𐌰𐌹𐍃𐌴𐌻𐍆
mythologia = 𐌼𐌹𐌸𐍉𐌻𐍉𐌲̈𐌹𐌰
mythologi = 𐌼𐌹𐌸𐍉𐌻𐍉𐌲̈𐌹
m = 𐌼
naive = 𐌽𐌰𐌹𐍅̈
naked = 𐌽𐌴𐌹𐌺𐌴𐌳
name’s = 𐌽𐌴𐌹𐌼’𐌶
names = 𐌽𐌴𐌹𐌼𐌶
name = 𐌽𐌴𐌹𐌼
narrower = 𐌽𐌰𐍂𐍉𐌿𐌴𐍂
narrow = 𐌽𐌰𐍂𐍉𐌿
naturall = 𐌽𐌰𐍄𐌿̈𐍂𐌰𐌻
neither = 𐌽𐌹𐌹𐌸𐌴𐍂
nephews = 𐌽𐌴𐍅̈𐌴𐌿𐌶
nephew = 𐌽𐌴𐍅̈𐌴𐌿
next = 𐌽𐌴𐌺𐍃𐍄
nicorn’s = 𐌽𐌹𐌺𐍉𐍂𐌽’𐍃
ninety = 𐌽𐌰𐌹𐌽𐍄𐌹
nine = 𐌽𐌰𐌹𐌽
nobody = 𐌽𐍉𐌿𐌱𐍉𐌳𐌹
normally = 𐌽𐍉𐍂𐌼𐌰𐌻𐌻𐌹
northeast = 𐌽𐍉𐍂𐌸¬𐌹𐌹𐍃𐍄
noses = 𐌽𐍉𐌿𐌶𐌴𐌶
nose = 𐌽𐍉𐌿𐌶
nozzing = 𐌽𐍉𐌶𐌹𐌽𐌲
no = 𐌽𐍉𐌿
nth = 𐌽𐌸
nuffink = 𐌽𐍁𐍆𐌹𐌽𐌺
n = 𐌽
o2 = 𐍉𐌿
o3 = 𐍁
oad = 𐍉𐌿𐌳
obin’s = 𐍉𐌱𐌹𐌽’𐍃
ockatrice = 𐍉𐌺𐌰𐍄𐍂𐌹𐍇
ock = 𐍉𐌺
’o’d = ’𐌿’𐌳
of = 𐍁𐍆̔
oh = 𐍉𐌿
ok = 𐍉𐌿𐌺𐌴𐌹
’old = ’𐍉𐌻𐌳
’old = ’𐍉𐌿𐌻𐌳
’oliday = ’𐍉𐌻𐌹𐌳𐌴𐌹
ollapsible = 𐍉𐌻𐌰𐍀𐍃𐌹𐌱𐌴𐌻
olumn = 𐍉𐌻𐍁𐌼𐌽
oment’s = 𐍉𐌼𐌴𐌽𐍄’𐍃
oment = 𐍉𐌼𐌴𐌽𐍄
ommand = 𐍉𐌼𐌰𐌽𐌳
ompass = 𐍉𐌼𐍀𐌰𐍃
omplete = 𐍉𐌼𐍀𐌻𐌴̈𐍄
once = 𐍅𐍁𐌽𐍃
onderful = 𐍁𐌽𐌳𐌴𐍂𐍆𐌿𐌻
’onest = ’𐍉𐌽𐌴𐍃𐍄
ones = 𐍅𐍁𐌽𐌶
’ones = ’𐍉𐌽𐌴𐍃
one = 𐍅𐍁𐌽
ongoing = 𐍉𐌽𐌲𐍉𐌿𐌹𐌽𐌲
only = 𐍉𐌿𐌽𐌻𐌹
onl = 𐍉𐌽𐌻
ontario = 𐍉𐌽𐍄𐌰̈𐍂𐌹𐍉
ooer = 𐌿𐌴𐍂
ook = 𐌿𐌺
ool = 𐌿𐌻
oom = 𐌿𐌼
ooooo = 𐌿𐌿𐌿𐌿
ooos = 𐌿𐌿𐌶
ooo = 𐌿𐌿
oor = 𐌿𐍂
’oo’s =  ’𐌿’𐌶
’ootled = ’𐌿𐍄𐌴𐌻𐌳
ootled = 𐌿𐍄𐌻𐌴𐌳
’oo = ’𐌿
opened = 𐍉𐌿𐍀𐌴𐌽𐌴𐌳
open = 𐍉𐌿𐍀𐌴𐌽
’ope = ’𐍉𐌿𐍀
opular = 𐍉𐍀𐌿̈𐌻𐌰𐍂
’op = ’𐍉𐍀
orgeous = 𐍉𐍂𐌲̈𐍉𐍃
orld = 𐍁𐍂𐌻𐌳
’orrid = ’𐍉𐍂𐌹𐌳
’orrors = ’𐍉𐍂𐍉𐍂𐌶
ositive = 𐍉𐌶𐌹𐍄𐌹𐍅̈
otherwise = 𐍁𐌸𐌴𐍂𐍅𐌰𐌹𐌶
’ot = ’𐍉𐍄
oubt = 𐌰𐌿𐍄
ouldn’t = 𐌿𐌳𐌽’𐍄
ountry = 𐌰𐌿𐌽𐍄𐍂𐌹
ount = 𐌰𐌿𐌽𐍄
ourselve = 𐌰𐌿𐍂𐍃𐌴𐌻𐍆̔
’ouse = ’𐌰𐌿𐍃
ouse = 𐌰𐌿𐍃
outbreak = 𐌰𐌿𐍄𐌱𐍂𐌴𐌹𐌺
outside = 𐌰𐌿𐍄𐍃𐌰𐌹𐌳
overcome = 𐍉𐌿𐍆̔𐌴𐍂𐌺𐍁𐌼
overcrowded = 𐍉𐌿𐍆̔𐌴𐍂𐌺𐍂𐌰𐌿𐌳𐌴𐌳
overheard = 𐍉𐌿𐍆̔𐌴𐍂𐌷𐍁𐍂𐌳
overripe = 𐍉𐌿𐍆̔𐌴𐍂𐍂𐌰𐌹𐍀
overseer = 𐍉𐌿𐍆̔𐌴𐍂¬𐍃𐌹𐌴𐍂
over = 𐍉𐌿𐍆̔𐌴𐍂
’ow = ’𐌰𐌿
’o = ’𐌿
pacious = 𐍀𐌰̈𐍇𐌹𐍉𐍃
paddied = 𐍀𐌰𐌳𐌹𐌳
paoul = 𐍀𐌰𐌿𐌻
paris = 𐍀𐌰̈𐍂𐌹𐍃
parrot’s = 𐍀𐌰𐍂𐍉𐍄’𐍃
parrots = 𐍀𐌰𐍂𐍉𐍄𐍃
parrot = 𐍀𐌰𐍂𐍉𐍄
paths = 𐍀𐌰𐌸𐍃
peace = 𐍀𐌴̈𐍇
pecial = 𐍀𐌴𐍇𐌹𐌰𐌻
peech = 𐍀𐌹𐌹𐌺̈
peering = 𐍀𐌹𐌹𐍂𐌹𐌽𐌲
penelope’s = 𐍀𐌴𐌽𐌴𐌻𐍉𐍀𐌴’𐍃
penknife = 𐍀𐌴𐌽𐌺𐌽𐌰𐌹𐍆
peoples = 𐍀𐌴̈𐍀𐌴𐌻𐌶
people’s = 𐍀𐌴̈𐍀𐌴𐌻’𐍃
people = 𐍀𐌴̈𐍀𐌴𐌻
perfession = 𐍀𐌴𐍂𐍆𐌴𐍃𐌹𐍉𐌽
periwinkles = 𐍀𐌴𐍂𐌹𐍅𐌹𐌽𐌺𐌴𐌻𐌶
periwinkle = 𐍀𐌴𐍂𐌹𐍅𐌹𐌽𐌺𐌴𐌻
pestles = 𐍀𐌴𐍃𐌴𐌻𐌶
pestle = 𐍀𐌴𐍃𐌴𐌻
ph = 𐍆
pieces = 𐍀𐌴̈𐍇𐌴𐌶
piece = 𐍀𐌴̈𐍇
pie = 𐍀𐌰𐌹
pipes = 𐍀𐌰𐌹𐍀𐍃
pipe = 𐍀𐌰𐌹𐍀
piping = 𐍀𐌰𐌹𐍀𐌹𐌽𐌲
pleasedly = 𐍀𐌻𐌴̈𐌶𐌳𐌻𐌹
pleased = 𐍀𐌻𐌴̈𐌶𐌳
pleases = 𐍀𐌻𐌴̈𐌶𐌴𐌶
please = 𐍀𐌻𐌴̈𐌶
pleasing = 𐍀𐌻𐌴̈𐌶𐌹𐌽𐌲
pleeze = 𐍀𐌻𐌴̈𐌶
poles = 𐍀𐍉𐌿𐌻𐌶
pole = 𐍀𐍉𐌿𐌻
polish1 = 𐍀𐍉̈𐌻𐌹𐍃̈
pool = 𐍀𐌿𐌿𐌻
pride = 𐍀𐍂𐌰𐌹𐌳
proceeded = 𐍀𐍂𐍉𐍇𐌴̈𐌳𐌴𐌳
proceeding = 𐍀𐍂𐍉𐍇𐌴̈𐌳𐌹𐌽𐌲
proceeds = 𐍀𐍂𐍉𐍇𐌴̈𐌳𐌶
proceed = 𐍀𐍂𐍉𐍇𐌴̈𐌳
proceed = 𐍀𐍂𐍉𐍇𐌴̈𐌳
proclaimed = 𐍀𐍂𐍉𐌺𐌻𐌰̈𐌼𐌳
proclaiming = 𐍀𐍂𐍉𐌺𐌻𐌰̈𐌼𐌹𐌽𐌲
proclaims = 𐍀𐍂𐍉𐌺𐌻𐌰̈𐌼𐌶
proclaim = 𐍀𐍂𐍉𐌺𐌻𐌰̈𐌼
putin = 𐍀𐌿𐍄𐌹𐌽
putting = 𐍀𐌿𐍄𐌹𐌽𐌲
p = 𐍀
quake = 𐌺𐍅𐌴𐌹𐌺
quawk = 𐌺𐍅𐍁𐌿𐌺
queaky = 𐌺𐍅𐌹𐌹𐌺𐌹
queen = 𐌺𐍅𐌹𐌹𐌽
quickly = 𐌺𐍅𐌹𐌺𐌻𐌹
quicksands = 𐌺𐍅𐌹𐌺𐍃𐌰𐌽𐌳𐌶
quicksand = 𐌺𐍅𐌹𐌺𐍃𐌰𐌽𐌳
quick = 𐌺𐍅𐌹𐌺
raked = 𐍂𐌴𐌹𐌺𐍄
raker = 𐍂𐌴𐌹𐌺𐌴𐍂
rake = 𐍂𐌴𐌹𐌺
read2 = 𐍂𐌴𐌳
reading = 𐍂𐌹𐌹𐌳𐌹𐌽𐌲
read = 𐍂𐌹𐌹𐌳
realized = 𐍂𐌴̈𐌰𐌻𐌹̈𐌶𐌳
realizes = 𐍂𐌴̈𐌰𐌻𐌹̈𐌶𐌴𐌶
realize = 𐍂𐌴̈𐌰𐌻𐌹̈𐌶
realizing = 𐍂𐌴̈𐌰𐌻𐌹̈𐌶𐌹𐌽𐌲
really = 𐍂𐌴̈𐌰𐌻𐌻𐌹
real = 𐍂𐌴̈𐌰𐌻
reappeared = 𐍂𐌴𐌰𐍀𐌴̈𐍂𐌳
reappearing = 𐍂𐌴𐌰𐍀𐌴̈𐍂𐌹𐌽𐌲
reappears = 𐍂𐌴𐌰𐍀𐌴̈𐍂𐌶
reappear = 𐍂𐌴𐌰𐍀𐌴̈𐍂
reasoned = 𐍂𐌴̈𐌶𐍉𐌽𐌳
reasoning = 𐍂𐌴̈𐌶𐍉𐌽𐌹𐌽𐌲
reasons = 𐍂𐌴̈𐌶𐍉𐌽𐌶
reason = 𐍂𐌴̈𐌶𐍉𐌽
reason = 𐍂𐌴̈𐌶𐍉𐌽
recall1 = 𐍂𐌴̈𐌺𐍉𐌻
recall2 = 𐍂𐌴𐌺𐍉𐌻
recall = 𐍂𐌴𐌺𐍉𐌻
reechoed = 𐍂𐌴𐌴𐌺𐍉𐌳
reechoing = 𐍂𐌴𐌴𐌺𐍉𐌹𐌽𐌲
relief = 𐍂𐌴𐌻𐌴̈𐍆
relieved = 𐍂𐌴𐌻𐌴̈𐍅̈𐌳
relieves = 𐍂𐌴𐌻𐌴̈𐍅̈𐌶
relieve = 𐍂𐌴𐌻𐌴̈𐍅̈
relieving = 𐍂𐌴𐌻𐌴̈𐍅̈𐌹𐌽𐌲
remade = 𐍂𐌴𐌼𐌴𐌹𐌳
reminds = 𐍂𐌴𐌼𐌰𐌹𐌽𐌳𐌶
remind = 𐍂𐌴𐌼𐌰𐌹𐌽𐌳
remounted = 𐍂𐌴𐌼𐌰𐌿𐌽𐍄𐌴𐌳
remounting = 𐍂𐌴𐌼𐌰𐌿𐌽𐍄𐌹𐌽𐌲
remounts = 𐍂𐌴𐌼𐌰𐌿𐌽𐍄𐍃
remount = 𐍂𐌴𐌼𐌰𐌿𐌽𐍄
rescu = 𐍂𐌴𐍃𐌺𐌿̈
retreated = 𐍂𐌴𐍄𐍂𐌴̈𐍄𐌴𐌳
retreating = 𐍂𐌴𐍄𐍂𐌴̈𐍄𐌹𐌽𐌲
retreats = 𐍂𐌴𐍄𐍂𐌴̈𐍄𐍃
retreat = 𐍂𐌴𐍄𐍂𐌴̈𐍄
retributive = 𐍂𐌴𐍄𐍂𐌹𐌱𐌿̈𐍄𐌹𐍅̈
ride = 𐍂𐌰𐌹𐌳
riding = 𐍂𐌰𐌹𐌳𐌹𐌽𐌲
riend = 𐍂𐌴𐌽𐌳
riffled = 𐍂𐌹𐍆𐌴𐌻𐌳
right = 𐍂𐍁𐌹𐍄
rincess = 𐍂𐌹𐌽𐍇𐌴𐍃
ripe = 𐍂𐌰𐌹𐍀
rises = 𐍂𐌰𐌹𐌶𐌴𐌶
rise = 𐍂𐌰𐌹𐌶
rising = 𐍂𐌰𐌹𐌶𐌹𐌽𐌲
riumphant = 𐍂𐌹̈𐌿𐌼𐍆𐌰𐌽𐍄
rocodile = 𐍂𐍉𐌺𐍉𐌳𐌹̈𐌻
rode = 𐍂𐍉𐌿𐌳
rolled = 𐍂𐍉𐌿𐌻𐌳
rolling = 𐍂𐍉𐌿𐌻𐌹𐌽𐌲
rolls = 𐍂𐍉𐌿𐌻𐌶
roll = 𐍂𐍉𐌿𐌻
romontory = 𐍂𐍉𐌼𐍉𐌽𐍄𐍉𐍂𐌹
ropes = 𐍂𐍉𐌿𐍀𐍃
rope = 𐍂𐍉𐌿𐍀
rose1 = 𐍂𐍉̈𐌶
rose2 = 𐍂𐍉𐌿𐌶
rownish = 𐍂𐌰𐌿𐌽𐌹𐍃̈
rustlers = 𐍂𐍁𐍃𐌻𐌴𐍂𐌶
’r = ’𐍂
r = 𐍂
safely = 𐍃𐌴𐌹𐍆𐌻𐌹
safety = 𐍃𐌴𐌹𐍆𐍄𐌹
safe = 𐍃𐌴𐌹𐍆
safe = 𐍃𐌴𐌹𐍆
sake = 𐍃𐌴𐌹𐌺
sale = 𐍃𐌴𐌹𐌻
same = 𐍃𐌴𐌹𐌼
saved = 𐍃𐌴𐌹𐍆̔𐌳
saves = 𐍃𐌴𐌹𐍆̔𐌶
save = 𐍃𐌴𐌹𐍆̔
saving = 𐍃𐌴𐌹𐍆̔𐌹𐌽𐌲
says = 𐍃𐌴𐌶
scarcely = 𐍃𐌺𐌰̈𐍂𐍇𐌻𐌹
scarce = 𐍃𐌺𐌰̈𐍂𐍇
scared = 𐍃𐌺𐌴𐌹𐍂𐌳
scares = 𐍃𐌺𐌴𐌹𐍂𐌶
scare = 𐍃𐌺𐌴𐌹𐍂
scaring = 𐍃𐌺𐌴𐌹𐍂𐌹𐌽𐌲
screw = 𐍃𐌺𐍂𐌿
scythed = 𐍃𐌰𐌹𐌸𐍄
scythes = 𐍃𐌰𐌹𐌸𐍃
scythe = 𐍃𐌰𐌹𐌸
scything = 𐍃𐌰𐌹𐌸𐌹𐌽𐌲
scythin = 𐍃𐍇𐌹𐌸𐌹𐌽
seashore = 𐍃𐌴̈¬𐍃̈𐍉𐍂
seasickness = 𐍃𐌴̈¬𐍃𐌹𐌺𐌽𐌴𐍃
seasick = 𐍃𐌴̈¬𐍃𐌹𐌺
seas = 𐍃𐌴̈𐌶
seawater = 𐍃𐌴̈¬𐍅𐍉𐍄𐌴𐍂
seaweed = 𐍃𐌴̈¬𐍅𐌹𐌳
sea = 𐍃𐌴̈
seemed = 𐍃𐌹𐌹𐌼𐌳
seeming = 𐍃𐌹𐌹𐌼𐌹𐌽𐌲
seems = 𐍃𐌹𐌹𐌼𐌶
seem = 𐍃𐌹𐌹𐌼
seen = 𐍃𐌹𐌹𐌽
see = 𐍃𐌹𐌹
sen’s = 𐍃𐌴𐌽’𐍃
seventh = 𐍃𐌴𐍆̔𐌴𐌽𐌸
seven = 𐍃𐌴𐍆̔𐌴𐌽
sewed = 𐍃𐍅𐍉𐌿𐌳
sewing = 𐍃𐍅𐍉𐌿𐌹𐌽𐌲
sewn = 𐍃𐍅𐍉𐌿𐌽
sews = 𐍃𐍅𐍉𐌿𐌶
sew = 𐍃𐍅𐍉𐌿
se = 𐍃𐌹𐌹
shaded = 𐍃̈𐌴𐌹𐌳𐌴𐌳
shade = 𐍃̈𐌴𐌹𐌳
shaken = 𐍃̈𐌴𐌹𐌺𐌴𐌽
shake = 𐍃̈𐌴𐌹𐌺
shaking = 𐍃̈𐌴𐌹𐌺𐌹𐌽𐌲
shame = 𐍃̈𐌴𐌹𐌼
shan’t = 𐍃̈𐌰’𐌽𐍄
shaped = 𐍃̈𐌴𐌹𐍀𐍄
shapes = 𐍃̈𐌴𐌹𐍀𐍃
shape = 𐍃̈𐌴𐌹𐍀
shared = 𐍃̈𐌴𐌹𐍂𐌳
shares = 𐍃̈𐌴𐌹𐍂𐌶
share = 𐍃̈𐌴𐌹𐍂
sharing = 𐍃̈𐌴𐌹𐍂𐌹𐌽𐌲
she’d = 𐍃̈𐌹’𐌳
shell’s = 𐍃̈𐌴𐌻’𐌶
she’ll = 𐍃̈𐌹’𐌻
she’s = 𐍃̈𐌹’𐌶
she = 𐍃̈𐌹
shine = 𐍃̈𐌰𐌹𐌽
shining = 𐍃̈𐌰𐌹𐌽𐌹𐌽𐌲
shouldn’t = 𐍃̈𐌿𐌳’𐌽𐍄
sh = 𐍃̈
sidesaddle = 𐍃𐌰𐌹𐌳¬𐍃𐌰𐌳𐌴𐌻
sides = 𐍃𐌰𐌹𐌳𐌶
side = 𐍃𐌰𐌹𐌳
sidings = 𐍃𐌰𐌹𐌳𐌹𐌽𐌲𐌶
siding = 𐍃𐌰𐌹𐌳𐌹𐌽𐌲
sight = 𐍃𐍁𐌹𐍄
since = 𐍃𐌹𐌽𐍃
sites = 𐍃𐌰𐌹𐍄𐍃
site = 𐍃𐌰𐌹𐍄
sixth = 𐍃𐌹𐌺𐍃𐌸
sixtieth = 𐍃𐌹𐌺𐍃𐍄𐌹𐌸
sixty = 𐍃𐌹𐌺𐍃𐍄𐌹
six = 𐍃𐌹𐌺𐍃
sizes = 𐍃𐌰𐌹𐌶𐌴𐌶
size = 𐍃𐌰𐌹𐌶
slayeth = 𐍃𐌻𐌴𐌹𐌸
slide = 𐍃𐌻𐌰𐌹𐌳
sliding = 𐍃𐌻𐌰𐌹𐌳𐌹𐌽𐌲
slime = 𐍃𐌻𐌰𐌹𐌼
slimy = 𐍃𐌻𐌰𐌹𐌼𐌹
sloped = 𐍃𐌻𐍉𐌿𐍀𐍄
slopes = 𐍃𐌻𐍉𐌿𐍀𐍃
slope = 𐍃𐌻𐍉𐌿𐍀
sloping = 𐍃𐌻𐍉𐌿𐍀𐌹𐌽𐌲
smiled = 𐍃𐌼𐌰𐌹𐌻𐌳
smile = 𐍃𐌼𐌰𐌹𐌻
smiling = 𐍃𐌼𐌰𐌹𐌻𐌹𐌽𐌲
smoke = 𐍃𐌼𐍉𐌿𐌺
smythe = 𐍃𐌼𐌰𐌹𐌸
snake = 𐍃𐌽𐌴𐌹𐌺
sometime = 𐍃𐍁𐌼𐍄𐌰𐌹𐌼
sons = 𐍃𐍁𐌽𐌽𐌶
son = 𐍃𐍁𐌽𐌽
soufflé = 𐍃𐌿𐍆𐌻𐌴
soulfully = 𐍃𐍉𐌿𐍆𐌿𐌻𐌻𐌹
soulful = 𐍃𐍉𐌿𐍆𐌿𐌻
souls = 𐍃𐍉𐌿𐌻𐌶
soul = 𐍃𐍉𐌿𐌻
southeast = 𐍃𐌰𐌿𐌸¬𐌹𐌹𐍃𐍄
sowed = 𐍃𐍉𐍅𐌳
sowing = 𐍃𐍉𐍅𐌹𐌽𐌲
sown = 𐍃𐍉𐍅𐌽
sows = 𐍃𐍉𐍅𐌶
sow = 𐍃𐍉𐍅
so = 𐍃𐍉𐌿
so = 𐍃𐍉𐌿
spades = 𐍃𐍀𐌴𐌹𐌳𐌶
spade = 𐍃𐍀𐌴𐌹𐌳
spare = 𐍃𐍀𐌴𐌹𐍂
specially = 𐍃𐍀𐌴𐍇𐌹𐌰𐌻𐌻𐌹
species = 𐍃𐍀𐌴̈𐍇𐌹𐌴𐌶
spider = 𐍃𐍀𐌰𐌹𐌳𐌴𐍂
spies = 𐍃𐍀𐌹̈𐌶
spoken = 𐍃𐍀𐍉𐌿𐌺𐌴𐌽
spokesman = 𐍃𐍀𐍉𐌿𐌺𐍃¬𐌼𐌰𐌽
spoke = 𐍃𐍀𐍉𐌿𐌺
spy’s = 𐍃𐍀𐌹̈’𐍃
spy = 𐍃𐍀𐌹̈
square = 𐍃𐌺𐍅𐌰̈𐍂
squawk = 𐍃𐌺𐍅𐍁𐌿𐌺
squeaked = 𐍃𐌺𐍅𐌹𐌹𐌺𐍄
squeaking = 𐍃𐌺𐍅𐌹𐌹𐌺𐌹𐌽𐌲
squeaks = 𐍃𐌺𐍅𐌹𐌹𐌺𐍃
squeaky = 𐍃𐌺𐍅𐌹𐌹𐌺𐌹
squeak = 𐍃𐌺𐍅𐌹𐌹𐌺
squeezed = 𐍃𐌺𐍅𐌹𐌹𐌶𐌳
squeezes = 𐍃𐌺𐍅𐌹𐌹𐌶𐌴𐌶
squeeze = 𐍃𐌺𐍅𐌹𐌹𐌶
sr = 𐍃𐍂
stake = 𐍃𐍄𐌴𐌹𐌺
stared = 𐍃𐍄𐌴𐌹𐍂𐌳
stare = 𐍃𐍄𐌴𐌹𐍂
steering = 𐍃𐍄𐌹𐌹𐍂𐌹𐌽𐌲
stephenson’s = 𐍃𐍄𐌴̈𐍅̈𐌴𐌽𐍃𐍁𐌽’𐍃
stephenson = 𐍃𐍄𐌴̈𐍅̈𐌴𐌽𐍃𐍁𐌽
stolen = 𐍃𐍄𐍉𐌿𐌻𐌴𐌽
stole = 𐍃𐍄𐍉𐌿𐌻
stones = 𐍃𐍄𐍉𐌿𐌽𐌶
stone = 𐍃𐍄𐍉𐌿𐌽
stony = 𐍃𐍄𐍉𐌿𐌽𐌹
strikes = 𐍃𐍄𐍂𐌰𐌹𐌺𐍃
strike = 𐍃𐍄𐍂𐌰𐌹𐌺
striped = 𐍃𐍄𐍂𐌰𐌹𐍀𐍄
stripes = 𐍃𐍄𐍂𐌰𐌹𐍀𐍃
stripe = 𐍃𐍄𐍂𐌰𐌹𐍀
strode = 𐍃𐍄𐍂𐍉𐌿𐌳
stroke = 𐍃𐍄𐍂𐍉𐌿𐌺
st = 𐍃𐍄
succeeded = 𐍃𐌿𐌺𐍇𐌴̈𐌳𐌴𐌳
succeeding = 𐍃𐌿𐌺𐍇𐌴̈𐌳𐌹𐌽𐌲
succeeds = 𐍃𐌿𐌺𐍇𐌴̈𐌳𐌶
succeed = 𐍃𐌿𐌺𐍇𐌴̈𐌳
successfully = 𐍃𐌿𐌺𐍇𐌴𐍃𐍆𐌿𐌻𐌻𐌹
successful = 𐍃𐌿𐌺𐍇𐌴𐍃𐍆𐌿𐌻
sugar = 𐍃̈𐌿𐌲𐌰𐍂
sunbathing = 𐍃𐍁𐌽¬𐌱𐌴𐌹𐌸𐌹𐌽𐌲
sunshine = 𐍃𐍁𐌽𐍃̈𐌰𐌹𐌽
sunstroke = 𐍃𐍁𐌽𐍃𐍄𐍂𐍉𐌿𐌺
sun = 𐍃𐍁𐌽
sure = 𐍃̈𐌿𐍂
surveilled = 𐍃𐍁𐍂𐍅̈𐌴𐌹𐌻𐌳
swollen = 𐍃𐍅𐍉𐌿𐌻𐌴𐌽
swords = 𐍃𐍉𐍂𐌳𐌶
sword = 𐍃𐍉𐍂𐌳
sympathique = 𐍃𐌹𐌼𐍀𐌰𐌸𐌹𐌺
s = 𐍃
tabitha’s2 = 𐍄𐌰𐌱𐌹𐌸𐌰’𐌶
taiwan = 𐍄𐌰𐌹𐍅𐌰𐌽
taken = 𐍄𐌴𐌹𐌺𐌴𐌽
takes = 𐍄𐌴𐌹𐌺𐍃
take = 𐍄𐌴𐌹𐌺
taking = 𐍄𐌴𐌹𐌺𐌹𐌽𐌲
tales = 𐍄𐌰̈𐌻𐌶
tale = 𐍄𐌰̈𐌻
tamest = 𐍄𐌴𐌹𐌼𐌴𐍃𐍄
tame = 𐍄𐌴𐌹𐌼
tape = 𐍄𐌴𐌹𐍀
tear1 = 𐍄𐌹𐍂
tear2 = 𐍄𐌴𐍂
tearful = 𐍄𐌹𐍂𐍆𐌿𐌻
tearing = 𐍄𐌴𐍂𐌹𐌽𐌲
tears1 = 𐍄𐌹𐍂𐌶
tears2 = 𐍄𐌴𐍂𐌶
tephen = 𐍄𐌴̈𐍅̈𐌴𐌽
terrel’s = 𐍄𐌴𐍂𐌴𐌻’𐍃
terrel = 𐍄𐌴𐍂𐌴𐌻
teven = 𐍄𐌴̈𐍅̈𐌴𐌽
that’s = 𐌸𐌰𐍄’𐌶
their = 𐌸𐌴𐌹𐍂
theophilus = 𐌸𐌴𐍉𐍆𐌹𐌻𐌿𐍃
there’r = 𐌸𐌴𐍂’𐍂
there’s = 𐌸𐌴𐍂’𐌶
these = 𐌸𐌹𐌹𐌶
they’re = 𐌸𐌴𐌹’𐍂
they’r = 𐌸𐌴𐌹’𐍂
they’ve = 𐌸𐌴𐌹’𐍆̔
the = 𐌸𐌹
thirty = 𐌸𐍁𐍂𐍄𐌹
thistledown = 𐌸𐌹𐍃𐌴𐌻𐌳𐌰𐌿𐌽
those = 𐌸𐍉𐌿𐌶
threadlike = 𐌸𐍂𐌴𐌳𐌻𐌰𐌹𐌺
threw = 𐌸𐍂𐌴𐌿
throug = 𐌸𐍂𐌿
thyme = 𐍄𐌹̈𐌼
th = 𐌸
tidal = 𐍄𐌰𐌹𐌳𐌰𐌻
tied = 𐍄𐌰𐌹𐌳
tie = 𐍄𐌰𐌹
tiled = 𐍄𐌰𐌹𐌻𐌳
time’s = 𐍄𐌰𐌹𐌼’𐌶
times = 𐍄𐌰𐌹𐌼𐌶
time = 𐍄𐌰𐌹𐌼
tiniest = 𐍄𐌰𐌹𐌽𐌹𐌴𐍃𐍄
tiny = 𐍄𐌰𐌹𐌽𐌹
tiptoed = 𐍄𐌹𐍀𐍄𐍉𐌿𐌳
tired = 𐍄𐌰𐌹𐍂𐌳
tire = 𐍄𐌰𐌹𐍂
today = 𐍄𐌿𐌳𐌴𐌹
toes = 𐍄𐍉𐌿𐌶
toe = 𐍄𐍉𐌿
together = 𐍄𐌿𐌲𐌴𐌸𐌴𐍂
togoland = 𐍄𐍉̈𐌲𐍉𐌻𐌰𐌽𐌳
toink = 𐍄𐍉𐌹𐌽𐌺
tomorrow = 𐍄𐌿𐌼𐍉𐍂𐍉𐌿
tonight = 𐍄𐌿𐌽𐍁𐌹𐍄
too = 𐍄𐌿𐌿
towards = 𐍄𐌿𐍅𐍉𐍂𐌳𐌶
toward = 𐍄𐌿𐍅𐍉𐍂𐌳
towed = 𐍄𐍉𐍅𐌳
towing = 𐍄𐍉𐍅𐌹𐌽𐌲
tows = 𐍄𐍉𐍅𐌶
tow = 𐍄𐍉𐍅
trader = 𐍄𐍂𐌴𐌹𐌳𐌴𐍂
trades = 𐍄𐍂𐌴𐌹𐌳𐌶
trade = 𐍄𐍂𐌴𐌹𐌳
trading = 𐍄𐍂𐌴𐌹𐌳𐌹𐌽𐌲
transparent = 𐍄𐍂𐌰𐌽𐍃𐍀𐌰𐍂𐌴𐌽𐍄
treat = 𐍄𐍂𐌴̈𐍄
trees = 𐍄𐍂𐌹𐌹𐌶
tree = 𐍄𐍂𐌹𐌹
tridgle = 𐍄𐍂𐌹𐌳𐌲𐌴𐌻
tried = 𐍄𐍂𐌰𐌹𐌳
triumphalist = 𐍄𐍂𐌹̈𐍁𐌼𐍆𐌰𐌻𐌹𐍃𐍄
troublemakers = 𐍄𐍂𐍁𐌱𐌴𐌻¬𐌼𐌴𐌹𐌺𐌴𐍂𐌶
troublemaker = 𐍄𐍂𐍁𐌱𐌴𐌻¬𐌼𐌴𐌹𐌺𐌴𐍂
true = 𐍄𐍂𐌿
truly = 𐍄𐍂𐌿𐌻𐌹
truthfully = 𐍄𐍂𐌿𐌸𐍆𐌿𐌻𐌻𐌹
truthful = 𐍄𐍂𐌿𐌸𐍆𐌿𐌻
truth = 𐍄𐍂𐌿𐌸
trying = 𐍄𐍂𐌰𐌹𐌹𐌽𐌲
twice = 𐍄𐍅𐌰𐌹𐍃
two = 𐍄𐍅𐌿
tying = 𐍄𐌰𐌹𐌹𐌽𐌲
typhoon = 𐍄𐌰𐌹𐍆𐌿𐌽
t = 𐍄
ubstitute = 𐍁𐌱𐍃𐍄𐌹𐍄𐌿̈𐍄
uccessful = 𐍁𐌺𐍇𐌴𐍃𐍆𐌿𐌻
uch = 𐍁𐌺̈
ucket = 𐍁𐌺𐌴𐍄
uck’s = 𐍁𐌺’𐍃
udden = 𐍁𐌳𐌴𐌽
ueen = 𐍅𐌴̈𐌽
uffin = 𐍁𐍆𐌹𐌽
’uge = ’𐌿̈𐌲̈
uge = 𐌿̈𐌲̈
uggest = 𐍁𐌲𐌴𐍃𐍄
uiet = 𐌿𐌹𐌹𐍄
uisance = 𐌿𐍃𐌰𐌽𐍇
ulp = 𐍁𐌻𐍀
unawares = 𐍁𐌽𐌰𐍅𐌴𐌹𐍂𐌶
unaware = 𐍁𐌽𐌰𐍅𐌴𐌹𐍂
unch = 𐍁𐌽𐌺̈
undergo = 𐍁𐌽𐌳𐌴𐍂𐌲𐍉𐌿
undertake = 𐍁𐌽𐌳𐌴𐍂¬𐍄𐌴𐌹𐌺
uneart = 𐍁𐌽𐍁𐍂𐌸
’ungarian = ’𐍁𐌽𐌲𐌰𐍂𐌹𐌰𐌽
unlikely = 𐍁𐌽𐌻𐌰𐌹𐌺𐌻𐌹
unlike = 𐍁𐌽𐌻𐌰𐌹𐌺
unny = 𐍁𐌽𐌹
unrolled = 𐍁𐌽𐍂𐍉𐌿𐌻𐌳
unsafe = 𐍁𐌽𐍃𐌴𐌹𐍆
unsuccessfully = 𐍁𐌽𐍃𐌿𐌺𐍇𐌴𐍃𐍆𐌿𐌻𐌻𐌹
unsuccessful = 𐍁𐌽𐍃𐌿𐌺𐍇𐌴𐍃𐍆𐌿𐌻
unsureness = 𐍁𐌽𐍃̈𐌿𐍂𐌽𐌴𐍃
untie = 𐍁𐌽¬𐍄𐌰𐌹
upholstered = 𐍁𐍀𐍉𐌿𐌻𐍃𐍄𐌴𐍂𐌳
upholster = 𐍁𐍀𐍉𐌿𐌻𐍃𐍄𐌴𐍂
upon = 𐍁𐍀𐍉𐌽
upside = 𐍁𐍀𐍃𐌰𐌹𐌳
upstairs = 𐍁𐍀𐍃𐍄𐌴𐌹𐍂𐌶
upsy = 𐍁𐍀𐍃𐌹
up = 𐍁𐍀
’urt = ’𐍁𐍂𐍄
urved = 𐍁𐍂𐍅̈𐌳
use1 = 𐌿̈𐍃
use1 = 𐌿̈𐍃
use2 = 𐌿̈𐌶
use2 = 𐌿̈𐌶
uses1 = 𐌿̈𐍃𐌴𐌶
uses2 = 𐌿̈𐌶𐌴𐌶
uses = 𐌿̈𐌶𐌴𐌶
use = 𐌿̈𐌶
usical = 𐌿̈𐌶𐌹𐌺𐌰𐌻
ussr = 𐌿̈𐍃𐍃𐍂
uyghurs = 𐌿𐌹𐌲𐌿𐍂𐌶
uyghur = 𐌿𐌹𐌲𐌿𐍂
vacations = 𐍅̈𐌰𐌺𐌰̈𐍇𐌹𐍉𐌽𐌶
vacation = 𐍅̈𐌰𐌺𐌰̈𐍇𐌹𐍉𐌽
various = 𐍅̈𐌰𐍂𐌹𐍉𐍃
vegetable = 𐍅̈𐌴𐌲̈𐌴𐍄𐌰𐌱𐌴𐌻
vere = 𐍅̈𐍁𐍂
ve = 𐍅̈𐌹
vill = 𐍅̈𐌹𐌻
vixens = 𐍆̔𐌹𐌺𐍃𐌴𐌽𐌶
vixen = 𐍆̔𐌹𐌺𐍃𐌴𐌽
volunteered = 𐍅̈𐍉𐌻𐍁𐌽𐍄𐌴̈𐍂𐌳
volunteer = 𐍅̈𐍉𐌻𐍁𐌽𐍄𐌴̈𐍂
vould = 𐍅̈𐌿𐌳
’v = ’𐍅̈
v = 𐍅̈
waded = 𐍅𐌴𐌹𐌳𐌴𐌳
wade = 𐍅𐌴𐌹𐌳
waist = 𐍅𐌴𐌹𐍃𐍄
wake = 𐍅𐌴𐌹𐌺
ware = 𐍅𐌰̈𐍂𐌴
wasted = 𐍅𐌰̈𐍃𐍄𐌴𐌳
wastes = 𐍅𐌰̈𐍃𐍄𐍃
waste = 𐍅𐌰̈𐍃𐍄
wasting = 𐍅𐌰̈𐍃𐍄𐌹𐌽𐌲
waved = 𐍅𐌴𐌹𐍆̔𐌳
wavelets = 𐍅𐌴𐌹𐍆̔𐌻𐌴𐍄𐍃
wavelet = 𐍅𐌴𐌹𐍆̔𐌻𐌴𐍄
wavering = 𐍅𐌴𐌹𐍆̔𐌴𐍂𐌹𐌽𐌲
waves = 𐍅𐌴𐌹𐍆̔𐌶
wave = 𐍅𐌴𐌹𐍆̔
waving = 𐍅𐌴𐌹𐍆̔𐌹𐌽𐌲
weaponized = 𐍅𐌴𐍀𐍉𐌽𐌹̈𐌶𐌳
wearing = 𐍅𐌴𐌹𐍂𐌹𐌽𐌲
wears = 𐍅𐌴𐌹𐍂𐌶
wear = 𐍅𐌴𐌹𐍂
we’d = 𐍅𐌹’𐌳
weighed = 𐍅𐌴𐌾𐌳
weight = 𐍅𐌴𐌾𐍄
welcomed = 𐍅𐌴𐌻¬𐌺𐍁𐌼𐌳
welcomes = 𐍅𐌴𐌻¬𐌺𐍁𐌼𐌶
welcome = 𐍅𐌴𐌻¬𐌺𐍁𐌼
welcoming = 𐍅𐌴𐌻¬𐌺𐍁𐌼𐌹𐌽𐌲
we’ll = 𐍅𐌹’𐌻
wensleydale = 𐍅𐌴𐌽𐍃𐌻𐌹𐌳𐌴𐌹𐌻
were1 = 𐍅𐌴𐍂
weren’t = 𐍅𐍁𐍂’𐌽𐍄
weretoads = 𐍅𐌴𐍂¬𐍄𐍉𐌿𐌳𐌶
weretoad = 𐍅𐌴𐍂¬𐍄𐍉𐌿𐌳
werewolf = 𐍅𐌴𐍂¬𐍅𐌿𐌻𐍆
werewolves = 𐍅𐌴𐍂¬𐍅𐌿𐌻𐍆̔𐌶
we’re = 𐍅𐌹’𐍂
were = 𐍅𐍁𐍂
we’ve = 𐍅𐌹’𐍆̔
we = 𐍅𐌹
what’s = 𐍈𐍉𐍄’𐌶
wha = 𐍈𐌰
wheedled = 𐍈𐌹𐌹𐌳𐌴𐌻𐌳
wheeps = 𐍈𐌹𐌹𐍀𐍃
wheep = 𐍈𐌹𐌹𐍀
where’s = 𐍈𐌴𐍂’𐌶
Whereupon = 𐍈𐌴𐍂¬𐍁𐍀𐍉𐌽
whew = 𐍈𐌴𐌿
whe = 𐍈𐌴
while = 𐍈𐌰𐌹𐌻
whine = 𐍈𐌰𐌹𐌽
whining = 𐍈𐌰𐌹𐌽𐌹𐌽𐌲
whipsnade = 𐍈𐌹𐍀𐍃𐌽𐌴𐌹𐌳
white = 𐍈𐌰𐌹𐍄
who’d = 𐌷𐌿’𐌳
whoever = 𐌷𐌿𐌴𐍆̔𐌴𐍂
wholeheartedly = 𐌷𐍉𐌿𐌻𐌷𐌰𐍂𐍄𐌴𐌳𐌻𐌹
wholehearted = 𐌷𐍉𐌿𐌻𐌷𐌰𐍂𐍄𐌴𐌳
whole = 𐌷𐍉𐌿𐌻
whole = 𐌷𐍉𐌿𐌻
whom = 𐌷𐌿𐌼
whooshshshsh = 𐌷𐌿𐍃̈𐌷𐌷𐌷
whoo = 𐍅𐌿
whose = 𐌷𐌿𐌶
who’s = 𐌷𐌿’𐌶
who = 𐌷𐌿
wh = 𐍈
wide = 𐍅𐌰𐌹𐌳
wildlife = 𐍅𐌰𐌹𐌻𐌳¬𐌻𐌰𐌹𐍆
wimple = 𐍅𐌹𐌼𐍀𐌴𐌻
winsun = 𐍅𐌹𐌽𐍃𐌿𐌽
without = 𐍅𐌹𐌸𐌰𐌿𐍄
woebegone = 𐍅𐍉𐌿𐌱𐌴𐌲𐍉𐌽
woken = 𐍅𐍉𐌿𐌺𐌴𐌽
woke = 𐍅𐍉𐌿𐌺
won’t = 𐍅𐍉’𐌽𐍄
wooden = 𐍅𐌿𐌿𐌳𐌴𐌽
woods = 𐍅𐌿𐌿𐌳𐌶
wood = 𐍅𐌿𐌿𐌳
wot’re = 𐍅𐍉𐍄’𐍂
wot’s = 𐍅𐍉𐍄’𐌶
wot’s = 𐍅𐍉𐍄’𐍃
wouldn’t = 𐍅𐌿𐌳’𐌽𐍄
writer = 𐍂𐌰𐌹𐍄𐌴𐍂
writes = 𐍂𐌰𐌹𐍄𐍃
write = 𐍂𐌰𐌹𐍄
writhed = 𐍂𐌰𐌹𐌸𐌴𐌳
writhes = 𐍂𐌰𐌹𐌸𐌶
writhe = 𐍂𐌰𐌹𐌸
writhing = 𐍂𐌰𐌹𐌸𐌹𐌽𐌲
writing = 𐍂𐌰𐌹𐍄𐌹𐌽𐌲
w = 𐍅
xinjiang’s = 𐌺𐍃𐌹𐌽𐌲̈𐌹𐌰𐌽𐌲’𐍃
xinjiang = 𐌺𐍃𐌹𐌽𐌲̈𐌹𐌰𐌽𐌲
xi = 𐌺𐍃𐌹
x = 𐌺𐍃
yarring = 𐌾𐌰𐍂𐌹𐌽𐌲
yeast = 𐌾𐌴̈𐍃𐍄
yield = 𐌾𐌴̈𐌻𐌳
yihe = 𐌾𐌹𐌷𐌴
you’r = 𐌾𐌿’𐍂
yo = 𐌾𐍉𐌿
yphoon = 𐌹̈𐍆𐌿𐌽
ysterical = 𐌹𐍃𐍄𐌴𐍂𐌹𐌺𐌰𐌻
’ysterica = ’𐌹𐍃𐍄𐌴𐍂𐌹𐌺𐌰
ythological = 𐌹𐌸𐍉𐌻𐍉𐌲̈𐌹𐌺𐌰𐌻
y = 𐌾
zat = 𐌶𐌰𐍄
zay = 𐌶𐌴𐌹
za = 𐌶𐌰
zem = 𐌶𐌴𐌼
zere = 𐌶𐌴𐍂
zese = 𐌶𐌹𐌶
zis = 𐌶𐌹𐍃
zoological = 𐌶𐍉̈𐍉𐌻𐍉𐌲̈𐌹𐌺𐌰𐌻
zululand = 𐌶𐌿𐌻𐌿¬𐌻𐌰𐌽𐌳
zut = 𐌶𐍁𐍄

