# 002 ӕ є ѵ еѵ аѵ þ і ј ө ұ ­
# 003 а ӕ б в г д е є ж з и і ј к л м н о ө п р с т þ ѵ ұ у ф х ц ч ш

aaa = ааа
aahs = ааз
aah = аа
aa = аа
aband = абанд
aba = аба
abbottsville = аботсвіл
aberrations = аберӕціонес
aberration = аберӕціон
aberration = аберӕціон
abeyance = абејанц
absense = абсенс
absolvo = абсолво
abulurd = абулурд
abuse1 = абұс
abuse2 = абұз
abuses1 = абұсес
abuses2 = абұзес
’acadile = ’акадил
accompaniment = акомпанімент
accrued = акреѵед
accrues = акреѵес
accrue = акреѵ
accruing = акреѵінг
aches = ӕкес
ach = ач
acknowledge = акнолеж
acoma = акома
a’comin = а-кѵмін
acrobacy = акробаці
acrophobia = акрөфөбіа
ac = ек
adab = адаб
addendum = адендѵм
adds = адес
adieu = адеѵ
adi = аді
afc = афк
affairs = афӕрес
affair = афӕр
affaris = афӕрес
affrighting = афрајтінг
affrighting = афритінг
afloat = афлөт
afl = афл
afterimages = афтер¬імажес
afterimage = афтер¬імаж
after’im = афтер-ім
afterjets = афтержетес
agandar = агандар
agin = агін
agnusdeiquitolispecattamundi = агнусдеікуітоліспекатамунді
agonised = агонизед
agonises = агонизес
agonise = агониз
agonising = агонизінг
ago = агоу
agreed = агріјед
agreeing = агріјінг
agreements = агріјментес
agreement = агріјмент
agrees = агріјес
agree = агріј
aguile = агіл
ahaiyuta = ахаіјута
ahmmng = ааммнг
ah = аа
aichymiste = ӕјкіміст
aiee = ајіі
aie’s = аіе-с
aie’s = ајє-с
aie = аіе
aiihh = аііхх
ailed = ејлед
ailing = ејлінг
ails = ејлес
ail = ејл
ain’t = еј-нт
aips = аіпес
airburst = ӕрберст
aircar = ӕркар
airholes = ӕрхөлес
airplanes = ӕрплӕнес
airplane = ӕрплӕн
airshafts = ӕресхафтес
air = ӕр
ai’s = аі-с
aiyah = ајја
ai = аі
ajugari = ажугарі
akairi = акаірі
akarso = акарсо
akechi = акечі
aladdin’s = аладін-с
aladdin = аладін
alangue = аланге
albe = албє
alc = алк
alexandra’ll = алегзандра‑л
alia = аліа
alienness = ӕліеннесс
alien’s = ӕліен-с
alien = ӕліен
alighieri = алігіері
alist = аліст
allah’s = алаа-с
allah = алаа
all’d = ол’д
allensen = аленсен
allowing = алау¬інг
all’ve = ол-в
allweb = олуеб
almanak = алманак
almighdy = алмігді
alón = алон
altogether = олтогеþер
aluit = алуіт
alzheimer’s = алзхајмер-с
alzheimer = алзхајмер
amalfi = амалфи
amalite = амалит
ambergris = амбергріс
ambulanced = амбұланцед
amigette = амігет
amighty = амајті
amirite = амирит
amis’s = аміс-с
ami’s = амі-с
amme = ам
amores = аморес
ampoliros = амполірос
ampules = ампулес
ampule = ампул
amtal = амтал
anachronisms = анакронізмес
anæmia = анєміа
anæsthetic = анесþетік
anæsthetize = анєсþетиз
ancience = ӕнціенц
ancientry = ӕнціентрі
ancients = ӕнціентес
ancient = ӕнціент
ancis = анціс
andil = анділ
andral = андрал
angels = ӕнжелес
angel’s = ӕнжел-с
angel = ӕнжел
angorian’s = ангоріан‑с
angorian = ангоріан
angst = ангст
anirul = анірул
another’n = анѵþер’н
ansible = ансибл
antientropic = антіентропік
antilogic = антіложік
anywhere = еніуӕр
apcs = апкес
apcs = апкес
apc = апк
apey = ӕпі
aphides = афідес
aphorisms = афорізмес
aphroditæum = афродитеѵм
aphroditeum = афродитеѵм
aplomage = апломаж
appall’d = апол-д
appendy = апенді
appetising = апетизінг
appetitish = апетитіш
appomattox = апомматокс
approached = апрөчед
approaches = апрөчес
approaching = апрөчінг
approach = апрөч
appy = апі
aql = акл
arabesques = арабескес
aramsham = арамшам
arboreals = арбореалес
arboreal = арбореал
archaeohistorians = аркеохісторіанес
archibalds = арчіболдес
archiballs = арчіболес
archipelagos = аркіпелагөес
archipelago = аркіпелагө
arcologies = арколожіес
arcology = арколожі
arc’s = арк-с
arctower = арктауер
areas = ӕреаес
aren’t = ар-нт
arghhhhhh = аргхххххх
arkie’s = аркі-с
arkie = аркі
armaghast = армагаст
armorers = арморерес
armorer = арморер
arnists = арністес
arrakeen = аракєн
arrakis = аракіс
arraki = аракі
arrestor = арестор
arrondissement = арондісмент
arroyos = аројос
arrrgh = арррх
arrrrgh = арррргх
arsunt = арсунт
artintel = артінтел
arundez = арундез
arunning = арѵнінг
asafœtida = асафетіда
asahina = асахіна
ascertained = ацертенед
ascertaining = ацертенінг
ascertains = ацертенес
ascertain = ацертен
ashake = ашӕк
ashine = ашин
ashraf = ашраф
asiatic = ӕзіатік
aspera = аспера
asshole = асхөл
assumed = асұмед
assumes = асұмес
assume = асұм
assuming = асұмінг
assurances = ашұранцес
assurance = ашұранц
assured = ашұред
assures = ашұрес
assure = ашұр
assuring = ашұрінг
a’standin = а-стандін
astery = астері
as = аз
’as = ’ас
athapascan = аþапаскан
a’that = а-þат
atmospheres = атмосферес
atmosphere = атмосфер
atonals = атоналес
atreides = атреідєс
atticus’d = атікѵс’д
atticus’n’them’s = атікѵс-н-þем-ес
atticus’s = атікѵс‑с
attlee’s = атліј‑с
attn = атн
attorneys = атѵрніес
attorney = атѵрні
auf = ауф
auliya = ауліја
aumas = аумас
aunts = аѵнтес
aunt’s = аѵнт-с
aunty’ll = аѵнті‑л
aunty’s = аѵнті-с
aunty = аѵнті
aunt = аѵнт
aun = аѵн
authorities = аѵþорітіес
authority = аѵþоріті
autoappliance = аѵтө¬аплианц
autobellhop = аѵтө¬бел¬хоп
autoengineering = аѵтө¬енжінєрінг
autofire = аѵтөфир
autoimplants = аѵтөімплантес
automech = аѵтөмек
autosecretary = аѵтө¬секретарі
auuuuuuuuh = аѵѵѵѵѵѵѵѵѵ
avenues = авенұес
avery’ll = ӕвері‑л
awakes = ауӕкес
away = а¬уеј
awfully = аѵфѵллі
awonawilona = ауонауілона
awwwww = аѵѵѵѵѵ
axially = аксіаллі
ayat = ајат
ayes = ијес
aye = иј
azaleas = азалеаес
azalea = азалеа
azure = азұр
a = а
à = а
b1 = б1
baaaaaa = баааааа
baa = баа
baboochkas = бабучкаес
baboochka’s = бабучка‑с
baboochka = бабучка
backblast = бакбласт
back’n = бак’н
backtown = бактаун
badder’n = бадер-н
baddiwads = бадіуадес
baen = баен
baggier = багіер
bailed = бејлед
bailing = бејлінг
bails = бејлес
bail = бејл
baited = бејтед
baiting = бејтінг
baits = бејтес
bait = бејт
bai = бај
bakka = бака
baklawa = баклауа
bakunin = бакунін
balalaika = балалајка
balisets = балісетес
baliset’s = балісет-с
baliset = балісет
ballets = балејес
ballet = балеј
balthazar’s = балþазар-с
bammin = бамін
bap = бап
baradye = барадје
baraka = барака
barberings = барбрінгес
barefooted = бӕрфутед
bare = бӕр
barf = барф
bargained = баргенед
bargaining = баргенінг
bargains = баргенес
bargain = барген
barrrroooom = баррррууум
bars = барес
baseness = бејснесс
bashar’s = башар-с
bashevis = башевіес
bastards’ve = бастардес-в
bas = баз
bathloads = баþлөдес
bathwaite = баþуӕт
bat’s = бӕт-с
battlecry = батлкрај
baudelaire = бодлер
bbc = ббк
bbs = ббес
bb’s = бб-с
bb = бб
beached = біјчед
beaches = біјчес
beaching = біјчінг
beach = біјч
beaned = біјнед
beaning = біјнінг
beans = біјнес
bean = біјн
beardgo = бєрд¬гоу
bears = бејрес
bear = бејр
beasty = бєсті
beaten = біјтен
beating = біјтінг
beats = біјтес
beat = біјт
beautifully = бұтіфѵллі
becaus = бекаѵс
beddy = беді
bed’s = бед-с
bedwear = бедуејр
beerily = бєрілі
beers = бєрес
beest = бєест
bees = біјес
beeth = бєþ
bee = біј
befallen = бефолен
bef = беф
bein = бєін
bellingraths’ll = белінграþес-л
bellpush = белпуш
benares = бенарес
benito’s = беніто-с
bergerac = бержерак
bergson = бергсѵн
bernini’s = бӕрніні-с
bernini’s = берніні-с
bernini = бӕрніні
bernini = берніні
berries = беріес
berry = бері
berti = берті
bertol’s = бертол-с
bertol = бертол
berzowski = берзоускі
beslas = бєслас
bestos = бестос
betas = бетаес
beta = бета
betokeneth = бетөкенеþ
betrayales = бетрејалес
betrayal = бетрејал
betrayers = бетрејерес
betrayer = бетрејер
better’n = бетер’н
bettik = бетік
bettzeug = бетсојг
beurres = беѵрес
bewhiskered = беуіскеред
bewilderedly = беуілдередлі
bewt’s = беѵт-с
bewt = беѵт
beyetet = бејетет
beyond = бејонд
bezoomnies = безумніес
bezoomny = безумні
bhotanijib = бхотаніжіб
bhotani = бхотані
biannual = бианұал
biarritz = біарітц
biblio = бібліо
bicep = бицеп
bidets = бідејес
bidet = бідеј
bigger’n = бігер’н
biggy = бігі
bigynne = бігін
bikura’s = бікура-с
bikura = бікура
billyboy’s = білібој‑с
billyboy = білібој
billygoat = білігоут
bindu = бінду
bioed = биоед
biofactured = биөфактұред
bioluminescence = биөлұмінесценц
bioluminescent = биөлұмінесцент
biomonitors = биөмоніторес
bioprocessors = биөпроцесорес
biosciences = био¬сциенцес
bioscience = био¬сциенц
bioscience = биосциенц
biosculptor = биөскѵлптор
biotic = биөтік
biran = біран
birdman = бердман
birds = бердес
bird’s = берд-с
bird = берд
birlstone = берлстөн
birmingham = бермінгам
birthdays = берþдејес
birthday = берþдеј
birthing = берþінг
births = берþес
birthworld = берþуерлд
birth = берþ
biscuits = біскітес
biscuit = біскіт
bishamon = бішамон
bit’s = біт-с
bitva = бітва
bius = биѵс
bivouac = бівуак
blackmailed = блакмејлед
blackmailes = блакмејлес
blackmailing = блакмејлінг
blackmail = блакмејл
bladeless = блӕдлесс
bleedin = блєдін
bleerrrt = блєрррт
blerp = блерп
blinksquirt = блінкскуерт
bloated = блөтед
bloating = блөтінг
bloats = блөтес
bloat = блөт
bloomsbury = блумесбӕрі
blotches = блочес
bluebeard = блеѵбєрд
blueface = блеѵ¬фӕц
bluejays = блеѵжејес
bluejay = блеѵжеј
bluekelp = блеѵкелп
blueskins = блеѵскінес
blues = блеѵес
blue = блеѵ
bluish = блеѵіш
blured = блеред
bluring = блерінг
blurp = блерп
blurred = блеред
blurrily = блеррілі
blurring = блерінг
blurrrt = блерррт
blurs = блерес
blurs = блерес
blurted = блертед
blurting = блертінг
blurts = блертес
blurt = блерт
blur = блер
boasted = бөстед
boastful = бөстфѵл
boasting = бөстінг
boasts = бөстес
boast = бөст
boated = бөтед
boating = бөтінг
boats = бөтес
boat = бөт
bocaj = бокаж
bod = бод
bogman’s = богман‑с
bog’s = бог‑с
bokanovskification = бокановскіфікӕціон
bokanovskified = бокановскіфиед
bokanovskifies = бокановскіфиес
bokanovskifying = бокановскіфиінг
bokanovskify = бокановскіфи
bokanovsky’s = бокановскі-с
bokanovsky’s = бокановскі-с
bokanovsky = бокановскі
bokanovsky = бокановскі
bollems = болемес
bollem = болем
bolnoy = болној
bolshiest = болшіест
bombs = бомес
bomoko’s = бомоко-с
bomoko = бомоко
bonditure = бондітұр
bondsman = бондсман
bondsmen = бондсмен
bonged = бонгед
bongs = бонгес
boohoohooing = бухухуінг
boohoohoo = бухуху
booksack = буксак
bookstalls = бук¬столес
boomaboom = бумабум
boorjoyce = буржојц
boo’s = бу‑с
bootboy = бут¬бој
bootick = бутік
booyah = буја
boro2 = боро
borodino = бородіно
borough = бѵроу
bor = бор
boschian = боскіан
bosch = боск
boskage = боскаж
botherin = боþерін
bottomland = ботомланд
bouquets = букеес
bouquet = буке
bourkas = буркаес
bourka = бурка
’bout = ’баут
bow1 = боу
bow2 = бау
bowing1 = боуінг
bowing2 = бауінг
bows1 = боуес
bows2 = бауес
bow = бау
boyos = бојоес
boyth = бојþ
brachycephalic = бракіцефалік
brachy = бракі
bradlaugh = брадлаѵ
brahe’s = брахе-с
branom = брӕном
bratchnies = брачніес
bratchny = брачні
bratties = братіес
brawne = браѵн
breaking = брејкінг
breaks = брејкес
break = брејк
breathlessly = бреþлеслі
breath’s = бреþ-с
bressians = бресіанес
bressian = бресіан
bressia’s = бресіа-с
bressia = бресіа
brevy’s = бреві-с
brevy = бреві
bré = бре
’brids = ’брідес
’brids = брідес
brids = брідес
’brid = брід
brid = брід
brigaders = брігӕдерес
brigader = брігӕдер
brighd = брајд
bringin = брінгін
britten’s = брітен-с
britvas = брітваес
britva = брітва
broached = брөчед
broaches = брөчес
broaching = брөчінг
broach = брөч
brodsky’s = бродскі‑с
brontë = бронте
brooches = брөчес
brooch = брөч
brooko = бруко
broomp = брумп
brosatted = бросатед
brosat = бросат
brotherth = брѵþерþ
browbeating = браубіјтінг
browline = браулин
brrrrrr = брррррр
brrrrr = бррррр
brrrrzzzzrrrr = бррррззззрррр
brrr = бррр
bruiseboys = брұзбојес
bruiseboy = брұзбој
bruisy = бруізі
brushbroom = брѵшбрум
brushstrokes = брѵшстрөкес
bryton = бритон
bt = бт
bubastis = бубастіс
buckaroo = букару
bucketlike = бѵкетлик
bucketload = бѵкетлөд
buddislamic = бѵдісламік
bufords = буфордес
buford’s = буфорд‑с
bugatty = бѵгаті
bugfuck = бѵгфѵк
buglike = бѵглик
buh = бѵ
bulben = бѵлбен
buoyed = бујед
buoys = бујес
buoy = буј
burbled = берблед
burbles = берблес
burble = бербл
burbling = берблінг
burdened = берденед
burdening = берденінг
burdens = берденес
burden = берден
bureaucracy = бұро¬краці
bureaucratic = бұро¬кратік
bureaucrats = бұро¬кратес
bureaucrat = бұро¬крат
bureaus = бұроес
bureaux = бұроес
bureau = бұро
burgled = берглед
burgles = берглес
burgle = бергл
burgling = берглінг
burhan = бурхан
burials = беріалес
burial = беріал
buried = беріед
buries = беріес
burly = берлі
burnaway = бернауеј
burned = бернед
burning = бернінг
burns = бернес
burn = берн
burocracy = бұро¬краці
burocratic = бұро¬кратік
burocrats = бұро¬кратес
burocrat = бұро¬крат
burped = берпед
burping = берпінг
burps = берпес
burp = берп
burred = бѵред
burring = бѵрінг
burris’s = берріс-с
burris’t = берріс-т
burris’t = берріс’т
burrowed = бѵроуед
burrowing = бѵроуінг
burrows = бѵроуес
burrow = бѵроу
burrs = бѵрес
burr = бѵр
bursegs = бурсгес
burseg’s = бурсег-с
burseg = бурсег
bursted = берстед
bursting = берстінг
bursts = берстес
burst = берст
burying = беріінг
bury = бері
buscakri = бускакрі
bushido = бушідо
busybodies = бізі¬бодіес
busybody = бізібоді
butlerian = бѵтлеріан
butterbeans = бѵтербіјнес
butterbean = бѵтербіјн
butts = бѵттес
butt = бѵтт
buyers = бајерес
buyer = бајер
buying = бајінг
buys = бајес
buy = бај
bu = бу
bw = бу
by = би
b = б
c1 = ц1
c3 = к3
cabarets = кабареес
cabaret = кабаре
café = кафе
caffeine = кафєін
caid = каід
cakewalk = кӕкуаѵк
caladancastle = каладанкасл
caladanin = каладанін
caladan’s = каладан-с
caladan = каладан
calais = калеј
calcifer’s = калціфер‑с
calcifer = калціфер
calcoloured = калкѵлоред
cal’d = кол’д
calexico = калексіко
caliente = каліенте
call’d = кол-д
callin = колін
callousness = калоснесс
calm’d = калм’д
calms = калмес
calpurnia’s = калпѵрніа‑с
calpurnia = калпѵрніа
cal’s = кал-с
camellias = камєліаес
camellia = камєліа
camn = камн
campaigns = кампӕнес
campaign = кампӕн
canaille = канајл
cancery = канцері
candelilla = канделіла
candleglobes = кандлглөбес
cannot = каннот
canopus = канопѵс
can’tcha = кан‑ча
canterbury = кантербері
cantora = кантора
can’t = ка-нт
cap’n = кап’н
caprock = капрок
capulet = капұлет
caramels = карамелес
caram = карам
carcanet = карканет
careers = карєрес
careo = карео
carhouse = кархаус
cariad = каріад
carmans = карманес
carollus = каролус
carryalls = каріолес
carryall’s = каріол-с
carryall = каріол
carthag = карþаг
carvnel = карвнел
cassell’s = касел-с
’caster = ’кастер
casteth = кастеþ
castile = кастил
’casting = ’кастінг
’cast = ’каст
cataclysm = катаклізм
catatonia = кататоніа
catholics = каþолікес
catholic = каþолік
catterack = катерак
caughtcha = каѵтча
caupe = каупе
causeth = каусеþ
’cause = ’каѵз
cauterizer’s = каѵтеризер-с
caution’s = каѵціон-с
ca = ка
cc = кц
cd = кд
célèbre = целебр
censered = ценсеред
centaurs = центаѵрес
centered = центред
centering = центрінг
centerness = центрнесс
centerpost = центрпөст
centers = центрес
center = центр
centimetered = центімєтред
centimeters = центімєтрес
centimeter = центіметр
centimetres = центіметрес
centimetre = центіметр
centrifugally = центріфұгаллі
ceo’s = цео-с
ceo = цео
cepeda = цепеда
’cept = ’цепт
cerise = серіз
cesaris = цезаріес
cesari’s = цезарі‑с
cesari = цезарі
ceti = цеті
cf = кф
cgi = кжі
chairs = чӕрес
chair = чӕр
chakobsa = чакобса
chaladoor = чаладур
chaldees = колдєес
chalk = чаѵк
chalma = чалма
chameleon = камєлеон
chamomile = камоміл
champertous = чампертос
chani’s = чӕни-с
chani = чӕні
chanteys = чантіес
characteristically = кӕрактерістіклі
characterture = кӕрактертұр
chased = чӕцед
chases = чӕцес
chase = чӕц
chasha = чаша
chasing = чӕцінг
chasin = чӕцін
chasms = казмес
chassos = часоес
chasso = часо
chatt = чатт
chaumas = шоумас
chaumurky = шоумѵркі
chc = кхк
cheap = чіјп
cheatin = чєтін
cheenas = чєнаес
cheena = чєна
cheere = чєр
cheested = чєстед
cheesting = чєстінг
cheest = чєст
cheest = чєст
chellovecks = человекес
chelloveck’s = человек‑с
chelloveck = человек
chemavit = чемавіт
chenopods = ченоподес
cheops = кєопс
chepooka = чепука
cherem = черем
cherries = черіес
cherrywood = черіууд
cherry = чері
cherubs = черѵбес
cherub = черѵб
chestlight = честлит
chestplate = честплӕт
chevrolet = шевролеј
chewies = чеѵіес
chewin = чеѵін
chickenyard = чікенјард
chiffarobes = шіфарөбес
chiffarobe = шіфароуб
children’ve = чілдрен-в
chillun = чілѵн
chilly = чілі
chimera = кимєра
chinaberries = чинаберіес
chinaberry = чинабері
chinny = чіні
chiroptera = кироптера
chirrlupped = чіррлѵпед
chiseled = чізлед
chiselled = чізлед
chisels = чізлес
chisel = чізл
chloroformate = клороформат
chloropicrin = клоропікрін
choam = кхөам
chocbars = чокбарес
chocolates = чоколатес
chocolate = чоколат
chocsauce = чоксаѵц
choerilos = керілос
choir = куир
chomped = чомпед
choodessny = чудесні
choppin = чопін
chouhada = чухада
chrissakes = криссӕкес
chrissake = криссӕк
chromaluminum = кромалұмінѵм
chromoplastic = крөмопластік
chronos = кронос
chronotropic = кронотропік
chumble = чѵмбл
chumbling = чѵмблінг
churches = черчес
churchgoer = черчгоуер
churchill = черчіл
church’s = черч-с
churchtime = черчтим
churchyard = черчјард
church = черч
churned = чернед
churnes = чернес
churning = чернінг
churn = черн
chusuk = чусѵк
chypre = шіпр
ciao = чао
cibola = цібола
cicero’s = ціцеро-с
cielagos = ціелагоес
cielago’s = ціелаго-с
cielago = ціелаго
cignoro = цігноро
cik = цік
cio = кіо
circumvented = ціркѵмвентед
circumventing = ціркѵмвентінг
circumvents = ціркѵмвентес
circumvent = ціркѵмвент
cislunar = ціслұнар
civilizedly = цівілизедлі
clabbering = клаберінг
clackclack = клакклак
clackity = клакіті
clacky = клакі
clarity = кларіті
clawlike = клаѵлик
claxon’s = клаксон-с
clews = клеѵес
clew = клеѵ
cliché = кліше
clickclicked = клікклікед
climbs = климес
cloaked = клөкед
cloaking = клөкінг
cloaks = клөкес
cloak = клөк
clonal = клонал
clopclopclop = клопклопклоп
clopped = клопед
close1 = клөс
close2 = клөз
closed = клөзед
closeness = клөс¬несс
closer = клөсер
closest = клөсест
closes = клөзес
closing = клөзінг
closures = клөзұрес
clothyard = клоþјард
clowny = клауні
clues = клеѵес
clue = клеѵ
cluve = клұв
clype = клип
c’mahnnn = кмааннн
c’mon = к-мон
cnossos = кносос
c’n = к’н
co2 = ко2
coached = көчед
coaches = көчес
coaching = көчінг
coach = көч
coalitions = кө¬аліціонес
coalition = кө¬аліціон
coanua = коануа
coarse = коурс
coated = көтед
coating = көтінг
coats = көтес
coat = көт
cocaine = кокӕін
cochiti = кочіті
cod’s = код-с
coevolved = коеволвед
cogged = когед
coital = којтал
coldsleep = көлд¬слєп
colfax = колфакс
collegiate = колежіат
collocoll = колокол
cologne = колөн
colonels = кѵрнелес
colonel’s = кѵрнел-с
colonel’s = кѵрнел-с
colonel = кѵрнел
colours = кѵлорес
columns = колѵмес
comesin = кѵмсін
coming’s = кѵмінг-с
comin = кѵмін
comlines = комлинес
comlogs = комлогес
comlog’s = комлог-с
comlog = комлог
committees = комітєес
committee = комітє
commlink = комлінк
comms = комес
communinet = комұнінет
comm = ком
compaction = компакціон
comparison = компарісон
complainin = комплӕнін
complexion = комплексіон
comp’ny = кѵмп’ні
compromisingly = компромизінглі
comsats = комсатес
comtaps = комтапес
comthreads = ком¬þредес
comthreads = комþредес
comthread = ком¬þред
concerto = кончертө
concie = конціе
concurrently = конкѵррентлі
conditionings = кондіціонінгес
Coninghams = көнінгамес
coninghams = кѵнінгамес
Coningham = көнінгам
conscience = консціенц
construction = кон¬стрѵк¬ціон
consul’s = консѵл-с
continua = контінұа
continues = контінұес
controllership = контрөлершіп
conveyance = конвејанц
conveyors = конвејорес
conveyor = конвејор
coolum’s = кулѵм-с
cooties = кутіес
cootie’s = куті‑с
cootie = куті
copilot’s = көпілот-с
copyrighted = копірајтед
copyrighting = копірајтінг
copyrights = копірајтес
copyright = копірајт
cordially = кордіаллі
coriolis = коріоліс
corrinos = коріноес
corrino = коріно
corskol = корскол
cottonfields = котонфєлдес
coughs = кофес
could’a = куд-а
coulda = куда
couldn’t = куд-нт
could = куд
counterfeint = каунтерфӕнт
counterinvasion = каунтерінвӕзіон
countersurges = каунтерсѵржес
counterthrusts = каунтерþрѵстес
counterthrust = каунтерþрѵст
couriers = куріерес
courier = куріер
courtiers = кортіерес
courtroom = корт¬рум
coverflight = кѵверфлит
coverrant = кѵверант
coyotes = којөтеес
coyote = којөте
co = ко
cpbs = кпбес
cpb = кпб
cpd = кпд
cra2 = кра2
crablike = краблик
crapehangers = крӕп¬хангерес
crarking = краркінг
crasted = крастед
crasting = крастінг
crast = краст
crayons = крејонес
crayon = крејон
creaked = кріјкед
creaking = кріјкінг
creaks = кріјкес
creak = кріјк
creatures = крєатұрес
creature = крєатұр
creches = крешес
crèches = крешес
creche = креш
crèche = креш
crèche = креш
creeched = крєчед
creeches = крєчес
creechings = крєчінгес
creeching = крєчінг
creepily = крєпілі
creg = крег
crepey = крӕпі
cresfem = кресфем
crewnshaw = креѵншаѵ
crews = креѵес
criticisms = крітіцізмес
croaked = крөкед
croakily = крөкілі
croaking = крөкінг
croaks = крөкес
croak = крөк
croches = крошес
croche = крош
croupier = крупіер
cruciform = крұціформ
cruelty = крұелті
cryogenie = криожєні
cryonic = крионік
crysknife’s = кріснајф-с
crysknife = кріснајф
crysknives = кріснајвес
csa = кса
ctystid = ктістід
cubies = кұбіес
cubie = кұбі
cub’s = кѵб-с
cue = кұ
cunninghams = кѵнінгамес
cunningham’s = кѵнінгам-с
cunningham = кѵнінгам
cupboards = кѵпбордес
cupboard = кѵпборд
cups’n = кѵпс’н
cures = кұрес
curettement = кұретмент
curies = кұріес
currency = кѵренці
currently = кѵрентлі
currents = кѵрентес
current = кѵрент
cussin = кѵсін
cutex = кѵтекс
cutterays = кѵтерајес
cutteray = кѵтереј
cvas = кваес
cybele = цібеле
cybercops = циберкопес
cybernet = цибернет
cyberpukese = циберпұкєз
cyberpukes = циберпұкес
cyberpuke = циберпұк
cybrids = цибрідес
cybrid’s = цибрід-с
cybrid = цибрід
czigo’s = тціго-с
czigo = тціго
c = ц
daal = даал
dadada = дадада
dadda = дада
dais = дӕіс
d’alembert = д’алемберт
damned = даммед
damning = даммінг
damns = даммес
damn = дамм
daren’t = дӕр-нт
darkin = даркін
datachip = дӕтачіп
datafix = дӕтафікс
dataspheres = дӕта¬сфєрес
datasphere = дӕта¬сфєр
dataways = дӕтауејес
daton’s = дӕтон-с
daton = дӕтон
datumnet = датѵмнет
datumplane = датѵмплӕн
datumplane = дӕтѵмплӕн
daybreak = дејбрејк
daylight = дејлит
daytime = дејтим
daywise = дејуиз
’da = -да
deactivation = деактівӕціон
deadcast = дедкаст
deadline = дед¬лин
dearest = діјрест
dears = діјрес
dear = діјр
deas’ll = дєас‑л
deas’s = дєас-с
deas = дєас
deathbeams = деþбємес
deathbeam = деþбєм
deathwands = деþуондес
deathwand = деþуонд
deathwards = деþуордес
deauville = даѵвіл
decomposers = декомпөзерес
decomposer = декомпөзер
decondition = декондіціон
decreed = декріјед
decreeing = декріјінг
decrees = декріјес
decree = декріј
decreps = декрепес
d’edgar = д’едгар
ded = дед
defendin = дефендін
defiled = дефилед
defiles = дефилес
defile = дефил
defiling = дефилінг
dehavre = дехавр
deigned = дејнед
deigning = дејнінг
deigns = дејнес
deign = дејн
déjà = дежа
dekenar = декенар
delafields = делафєлдес
delafield = делафєлд
delighted = делитед
delighting = делитінг
delights = делитес
delight = делит
delish = деліш
del’s = дел-с
deneb = денеб
denieve = деніев
departeth = департеþ
depots = дєпоес
derch = дерч
derehn = дерен
dere = дере
desdemona = десдемона
desperate = десперат
desp’rate = деспрат
destructionist = дестрѵкціоніст
detectivology = детектіволожі
detoured = детуред
detouring = детурінг
detours = детурес
detour = детур
detresque’s = детреск-с
d’être = д-етр
deturgescence = детѵржесценц
deutschland = дојчланд
devaluin = девалұін
deviation = девіӕціон
deviou = дєвіо
devi = деві
devotchkas = девочкаес
devotchka’s = девочка‑с
devotchka = девочка
de = де
dichlorethyl = діклореþіл
didn’t = дід-нт
didst = дідст
digitalized = діжітализед
dignidad = дігнідад
dildo = ділдо
dill’ll = діл‑л
dim’s = дім-с
dingalingaling = дінгалінгалінг
diningroom = динінгрум
dinnerbell = дінербел
dionysus = діонисѵс
diphenylcyanarsine = дифєнілціанарсін
dirige = діріге
dirted = дертед
dirtier = дертіер
dirtiest = дертіест
dirty = дерті
dirt = дерт
disagreed = дісагріјед
disagreeing = дісагріјінг
disagrees = дісагріјес
disagree = дісагріј
disassembling = дісасемблінг
discarnate = діскарнат
disembodied = дісембодіед
disembodies = дісембодіес
disembodying = дісембодіінг
disembody = дісембоді
disgracin = дісгрӕцін
dislinear = діслинеар
disminded = дісминдед
dismind = дісминд
disorientated = дісоріентӕтед
distangled = дістанглед
distracters = дістрактерес
distrans = дістранес
disturbin = дістѵрбін
dl = дл
dna = дна
dobby = добі
docs = докс
doesn’t = дѵс-нт
does = дѵс
doggily = догілі
dogpetting = дог¬петінг
dogskin = догскін
doin = дуін
dolefully = дөлфѵллі
doleful = дөлфѵл
dolkan = долкан
dolphus = дөлфѵс
dolsa = долса
dolychocephalic = долікоцефалік
domeless = дөмлесс
domies = доміес
domy = думі
donel = донел
dont = донт
don’t = дө-нт
doobidoob = дубідуб
dook = дук
doomsday = думес¬деј
doorknobs = дорнобес
doorknob = дорноб
door’s2 = дор-с
doors = дорес
doppelgänger = допелгенгер
dorogoy = дорогој
dossiers = досіеес
dossier = досіе
dostoevsky’s = достојевскі‑с
dostoevsky = достојевскі
doughboys = доубојес
doughboy = доубој
doukhobor’s = дукобор-с
dourly = дурлі
dour = дур
down’n = даун’н
downstairs = даун¬стејрес
drachms = драмес
drachm = драм
draconi’s = дрӕкөні-с
draconi = дрӕкөні
draftees = драфтєес
draftee = драфтє
dratsing = дратсінг
draums = драѵмес
drawers = драѵерес
drawer = драѵер
dreamstuff = дрємстѵф
drei = дреі
drencrom = дренкром
dren = дрен
drinkin = дрінкін
drisq = дріск
droogies = другіес
droogie = другі
droogs = другес
droog’s = друг‑с
droogy = другі
droog = друг
dropshaft = дропшафт
dropships = дропшіпес
dropship = дропшіп
druggee = дрѵгіј
druglike = дрѵглик
drunkie = дрѵнкі
’druthers = ’дрѵþерес
dryly = драјлі
dryness = драјнесс
drypad = драјпад
dr = др
d’s = д-ес
duboses = дѵбөзес
dubose’s = дѵбөз-с
dubose = дѵбөз
dues = дұес
duke’d = дұк-д
duly = деѵлі
duncecap = дѵнскап
dunkey = дѵнкі
duomo = дұөмо
duralloy = дұралој
duraluminum = дұралұмінѵм
duress = дұресс
duré’s = дұре-с
duré = дұре
during = дұрінг
durin = дұрін
durulis = дуруліс
duy = дуј
dva = два
d’ya = д-ја
dyes = дијес
dyeworks = дијуеркес
dye = диј
dyin = дајін
dynamos = динамөес
’dyou = ’дұ
d’you = д-ұ
dystopian = дістопіан
’d = -д
’d = ’д
d = д
earhole = єрхөл
earpatches = єрпачес
earthlike = ерþлик
eastwards = єст­уордес
eatin = єтін
eavesdropped = євесдропед
eavesdroppers = євесдроперес
eavesdropper = євесдропер
eavesdropping = євесдропінг
eavesdrops = євесдропес
eavesdrop = євесдроп
ebaline = єбалін
ecas = екас
ecaz = еказ
éclair = еклӕр
ecocrats = еко¬кратес
ectogenesis = ектожєнесіс
ecumenism = екуменізм
ec = ек
Edinburgh = едін¬бѵро
edogawa = едогауа
edzel’s = едзел-с
edzel = едзел
eeeeeeeeeeeh = єєєєєєєєєє
eeeeee = єєєє
eeeep = ііііп
eegra = ігра
eelstone = єлстөн
eemyas = імјаес
eemya = імја
eep = ііп
e’er = е-ер
egeria’s = єжєріа-с
eggiwegs = егіуегес
eggiweg = егіуег
eggy = егі
ehalma = ехалма
eighe = аје
eighteenth = ејттєнþ
eighteen = ејттєн
eighth = ејтþ
eightieth = ејттіþ
eighty = ејтті
eight = ејт
eikhardt = еікхарт
einsteinian = ајнстајніан
einstein = ајнстајн
ekkeri = екері
elacca = елака
elasmosaurus = еласмозаѵрѵс
eldel = елдел
eloi = елој
elrood = елруд
elusiveness = елұсівнесс
’em’d = ’ем’д
empathic = емпаþік
empaths = емпаþес
employee = емплојє
emporotic = емпоротік
emps = емпес
’em’s = ’ем‑с
emvs = емвес
emvs = емвес
emv’s = емв-с
emv’s = емв-с
emv = емв
emv = емв
’em = ’ем
’em = ’ем
enantiomers = енантіомерес
enantiomer = енантіомер
enarmored = енарморед
encouraged = енкѵражед
encourage = енкѵраж
encroached = енкрөчед
encroaches = енкрөчес
encroaching = енкрөчінг
encroach = енкрөч
endin = ендін
endos = ендос
endymion = ендіміон
enfield = енфєлд
enfin = енфін
engels = енгелс
englobement = енглөбмент
englobe = енглөб
enseamed = енсіјмед
enspored = енспоред
enspore = енспор
en’s = ен-с
entrepreneurs = антрпренѵрес
entrepreneur = антрпренѵр
entretisser = ентретісер
entrisseur = ентрісеѵр
ephrem’s = єфрем-с
ephrem = єфрем
epicanthic = епіканþік
eppie = епі
epsilonhood = епсілонхѵд
equations = екуӕціонес
equation = екуӕціон
equus = екуус
erased = ерӕсед
erases = ерӕсес
erase = ерӕс
erasing = ерӕсінг
erebus = еребѵс
eridani = ерідані
erlk = ѵрлк
erosion’s = ерөзіон‑с
erotism = еротізм
erred = еред
erring = ерінг
errors = ерорес
error = ерор
errs = ерес
err = ер
ert = ерт
erupted = ерѵптед
erupting = ерѵптінг
erupts = ерѵптес
erupt = ерѵпт
escapable = ескӕпабл
escher = ескер
ese = єз
esmar = есмар
éso = éсо
especially = еспеціаллі
espers = есперес
esper = еспер
esp = есп
essentially = есенціаллі
essentials = есенціалес
essential = есенціал
etchingham = ечінгам
etc = етц
ethiop’s = еþіоп-с
ethy = еþі
eto = ето
etsanatlehi = етсанатлехі
euglena = еѵглєна
eulin = еѵлін
eunuchs = еѵнѵкес
euphorion = еѵфоріон
eurasians = еѵрӕзінес
euthelassia = еѵтеласіа
evenings = євнінгес
evening = євнінг
’evenin = євнін
evenin = євнін
everblues = еверблеѵес
everett’s = еверет-с
ever’thing’s = еверþінг-с
everything’d = евріþінг-д
everywhere = еврі¬уӕр
every = еврі
eve’s = евє-с
eve’s = єв-с
evil’s = євіл-с
evil = євіл
ewells = еѵелес
ewell = еѵел
ewes = еѵес
excentric = ексцентрік
excursionists = екскѵрсіоністес
excursionist = екскѵрсіоніст
excuse1 = екскұс
excuse2 = екскұз
excuses1 = екскұсес
excuses2 = екскұзес
exmoor = ексмор
exoskeletons = ексөскелетонес
expectin = експектін
expresseth = експрессеþ
extraordinarily = екстраордінӕрілі
extrasolar = екстрасөлар
extraterrestrial = екс¬тра¬терестріал
exudates = егзудӕтес
exuded = егзұдед
exudes = егзұдес
exude = егзұд
exuding = егзұдінг
eyeballs = ајболес
eyeball = ајбол
eyebrows = ајбрауес
eyebrow = ајбрау
eyed = ајед
eyeless = ај¬лесс
eyelids = ајлідес
eyelid = ајлід
eyepiece = ајпєц
eyesocket = ајсокет
eyes = ајес
eyewitnesses = ајуітнесес
eyewitness = ајуітнес
eye = ај
eyries = єріес
eyrie = єрі
ey = еј
e = е
faaa = фааа
façade = фацад
faceplate = фӕцплӕт
fahrenheit = фӕрен¬хајт
faints = фӕнтес
fairfax’s = фӕрф¬акс‑с
fairfax = фӕр¬факс
fairness = фејрнесс
fair = фејр # vs fare
fai = фај
fallatuke = фалатұк
fallbac = фолбак
fallen = фолен
falling = фолінг
falsehood = фолсхуд
falteringly = фолтерінглі
famicom = фаміком
familiarity = фаміліаріті
fancification = фанціфікатіон
fanderbags = фандербагес
fanderbag = фандербаг
fandies = фандіес
farcasters = фаркастерес
farcaster’s = фаркастер-с
farcaster = фаркастер
farcasting = фаркастінг
farcast = фаркаст
farewell = фӕр¬уел
fare = фӕр
farfarculule = фарфаркұлұл
farok = фарок
farraux = фаро
farraux = фаро
farrukh = фарух
fasartas = фазартаес
fasartas = фасартас
fashioned = фаціонед
fashions = фаціонес
fashion = фаціон
fatigued = фатігед
fatlined = фатлинед
fatline = фатлин
fatlining = фатлинінг
fat’s = фат-с
faufreluches = фаѵфрелукес
faxsimmed = факсімед
faxsimmed = факссімед
fbi = фбі
feared = фєред
feareth = фєреþ
fearing = фєрінг
fearless = фєрлесс
fear’st = фєрст
fears = фєрес
fear = фєр
feats = фіјтес
feat = фіјт
fedaykin = федајкін
fedmahn = федман
feebleness = фєблнесс
feelies = фєліес
feelin = фєлін
feelytone = фєлітөн
feif’s = фејф-с
feif = фејф
feigned = фејнед
feigning = фејнінг
feigns = фејнес
feign = фејн
felia = феліа
fenced = фенсед
fence’ll = фенс‑л
fences = фенсес
fence = фенс
fencing = фенсінг
fererra’s = ферера-с
fererra’s = ферера-с
ferick = ферік
ferret = ферет
ferried = феріед
ferries = феріес
ferries = феріес
ferro = феро
ferrying = феріінг
ferry = фері
fevarone = феварөн
feyd = фејд
fé = фе
fhluck = фхлѵк
fiancée = фіансе
fiancee = фіанце
fiancée = фіанце
fiancé = фіансе
fiberplastic = фиберпластік
fic = фік
fide2 = фиде
fiftieth = фіфтіþ
fightin = фитін
filigree = філігрє
fillet = філеј
fillied = філіед
fillissin = філісін
filltip = філтіп
fillying = філіінг
filmdrome’s = філмдрөм‑с
filmdrome = філмдрөм
filmtapes = філмтӕпес
filt = філт
finally = финаллі
finch’d = фінч’д
findin = финдін
fingerblades = фінгерблӕдес
fingerlike = фінгер¬лик
fiqh = фіх
firegolds = фиргөлдес
firegold = фиргөлд
fires = фирес
firewhip = фируіп
firm1 = фірм # company
firm2 = ферм # steadfast
firmer = фермер
firmest = фермест
firmly = фермлі
firm = ферм
firstborn = ферстборн
firstdown = ферстдаун
firsthand = ферст¬ханд
firstsite = ферстсит
first = ферст
firs = ферес
fir = фер
fishin = фішін
fishpool = фішпуул
fissure’s = фісұр-с
fistfights = фістфитес
fisties = фістіес
fistie = фісті
fisty = фисті
fitchew = фічеѵ
fittin = фітін
fixin = фіксін
fizzily = фізілі
flares = флӕрес
flatblocks = флатблокес
flatblock = флатблок
fleas = фліјес
flea = фліј
flechettes = флешетес
flechette = флешет
fleed = фліјед
fleeing = фліј¬інг
flees = фліјес
fleet’ll = флєт-л
flee = фліј
fleschettes = флешетес
fleschette = флешет
fleshless = флешлесс
flickflicked = флікфлікед
flickflickflicked = флікфлікфлікед
flipflap = фліпфлап
flipflop = фліпфлоп
flivvers = фліверес
flivver = флівер
floated = флөтед
floating = флөтінг
floats = флөтес
float = флөт
floggin = флогін
floors = флорес
floursack = флаурсак
flowfoam = флоуфоум
flowy = флоуі
flubbing = флѵбінг
flyer = флај¬ер
flyleaf = флајлєф
flyspace = флајспӕц
flywheel = флај¬уєл
fm = фм
fobd = фобд
foes = фоуес
foetal = фєтал
foetuses = фєтѵсес
foe = фоу
folklore = фөклор
folks’ll = фөкес‑л
folks’n = фөкес’н
folks’ve = фөкес-в
folks’ = фөкес-
folktales = фөктӕлес
folktale = фөктӕл
folk = фөк
follasy = фоласі
fomalhaut = фөмалхаѵт
fooled = фуулед
fooling = фуулінг
foolin = фуулін
foolishness = фуулішнесс
foolish = фууліш
fools = фуулес
fool = фуул
forcefields = форцфєлдес
forcefield = форцфєлд
fordey = форді
fordliness = фордлінесс
fordship’s = фордшіп-с
fordship = фордшіп
forebears = фор¬бејрес
forebear = фор¬бејр
foreknowledge = форкнолеж
forella = форела
foreve = форєв
’fore = ’фор
forficulate = форфікулӕт
forkful = форкфул
formosall = формөсал
formosan = формөсан
formosa = формөса
formulae = формұлӕ
forster’s = форстер-с
fortieth = фөр¬тіþ
fortunetellers = фортұн¬телерес
fortuneteller = фортұн¬телер
forty = фөр¬ті
fought’n’hollered = фаѵт-н-холеред
fours = фөрес
fourteenth = фөр¬тєнþ
fourths = фөрþес
fourth = фөрþ
four = фөр
foward = фоуорд
fo = фо
’fraid = ’фрӕд
frallup = фралѵп
frankenstein = франкен¬стајн
fra = фра
freedoms = фріј¬домес
freedom = фріј¬дом
freed = фріјед
freehold = фріј¬хөлд
freeholm = фріјхөм
freeing = фріјінг
freemartins = фрємартінес
freeways = фріј¬уејес
freeway = фріј¬уеј
fremen’s = фрємен-с
fremen = фрємен
fremkit = фремкіт
frenchhorn = френчхорн
fretsawyers = фрет¬саѵјерес
freudenberg = фројден¬берг
freud = фројд
freyn = фрејн
fridays = фрај¬дејес
friday = фрај¬деј
from = фром
frontiers = фронтєрес
fruitpie = фрұтпај
frutti = фруті
frutti = фрұті
f’r = ф’р
ftl = фтл
ftl = фтл
fuchsia = фұсіа
fujiwara = фужіуара
fukami = фукамі
fukuyou = фукујоу
fully = фуллі
fungusoid = фѵнгѵсоід
funnier’n = фѵніер’н
furigana = фурігана
furled = ферлед
furled = ферлед
furling = ферлінг
furling = ферлінг
furls = ферлес
furls = ферлес
furl = ферл
furl = ферл
furrowed = фѵроуед
furrowing = фѵроуінг
furrows = фѵроуес
furrow = фѵроу
furs = фѵрес
furthermore = ферþермор
further = ферþер
fur = фѵр
futilely = фұтиллі
futoshi = футоші
fuukoumeibi = фуукоумејбі
f = ф
gah = гаа
gaib = гајб
gaiety = гејеті
gainst = гејнст
’gainst = ’генст
gaited = гејтед
gaiting = гејтінг
gaits = гејтес
gait = гејт
gaius = гејѵс
galach = галеч
galacian = галаціан
galactophasic = галактофӕзік
galilee = галілє
gallerias = галеріаес
gametes = гамєтес
gamete = гамєт
gamont = гамонт
gam = гам
gandhipur = гандіпѵр
gaols = жӕлес
gaol = жӕл
garandool = гарандул
garenne = гарен
garrote = гарөт
garvarg = гарварг
gazettas = газетаес
gazetta = газета
geats = гєтес
geminids = жемінідес
geminid = жемінід
generally = женераллі
geniuses = жєніѵсес
genius = жєніѵс
genius = жєніѵс
genroku = генроку
gentians = женціанес
gentleman’s = жентлман-с
geoff’s = жеф-с
geographies = жеографіес
geological = жєоложікал
george = жорж
georgian = жоржіан
georgia = жоржіа
georgieboy = жоржібој
geroff = герофф
gesserit’s = жесеріт-с
gesserit = жесеріт
gestalting = жесталтінг
gethsemane = геþсеманє
getten = гетен
gettin = гетін
geyrat = гејрат
ghafla = гафла
ghanima = ганіма
ghoulies = гуліес
gibsonian = гібсоніан
giedi = гіеді
gilars = гіларес
gilmer’s = гілмер‑с
ginaz = жіназ
girders = гердерес
girder = гердер
girlfriends = герл¬френдес
girlies = герліес
girlish = герліш
girls = герлес
girl’s = герл-с
girl = герл
gismo = гізмо
gissen = гісен
gis = гіс
gitterfenster = гітерфенстер
git = гіт
giudichar = гіудічар
giveaway = гів­ауеј
gi = гі
gkkrgghh = гккрггхх
gladstone’s = гладстөн-с
gladstone = гладстөн
glanced = глансед
glances = глансес
glance = гланс
glancing = глансінг
glans = гланес
glasgow = гласгоу
glassite = гласит
glazzies = глазіес
glazzy = глазі
glaz = глаз
gleet = глєт
glill = гліл
gloated = глөтед
gloating = глөтінг
gloats = глөтес
gloat = глөт
globby = глобі
globelighted = глөблитед
glolp = глолп
gloominess = глумінесс
gloopy = глупі
gloop = глуп
glops = глопес
glossu = глосу
glowbirds = глоубердес
glued = глеѵед
glues = глеѵес
gluey = глеѵі
glue = глеѵ
gluing = глеѵінг
gnostic’s = гностік-с
go2 = го
goaders = гөдерес
goal = гөл
goatish = гөтіш
goats = гөтес
goaty = гөті
goat = гөт
gobbledegook = гоблдегук
goddammit = годдаміт
goddamned = годдаммед
goddamn = годдамм
goddes = годес
godiva = годива
goes = гоуес
goggly = гоглі
gogol = гогол
goings = гоуінгес
going = гоуінг
goin = гоуін
golosses = голосес
goloss = голос
gom = гом
gonadal = гөнадал
g’on = г-он
gon = гон
go’n = гоу’н
goobers = губерес
goober = губер
goodhumouredly = гудхұморедлі
good’n = гуд’н
googlepeds = гуглпедес
goolied = гуліед
gooly = гулі
goonda’s = гунда-c
goonda’s = гунда-c
goondas = гундаес
goondas = гундаес
goonda = гунда
goonda = гунда
goosedown = гусдаун
gorgeosity = горжосіті
gorgor = горгор
gorloes = горлоес
gorlo = горло
gotama = готама
gothie = гоþі
got’s = гот‑с
gottago = готагоу
gourmet = гурме
govamint’d = гѵвамінт-д
govoreeted = говорітед
govoreeting = говорітінг
govoreet = говоріт
go = гоу
gps = жпс
grabbies = грабіес
grabbie = грабі
grâce = грац
gradually = градұаллі
graham = грејам
grahzny = гразні
gramodisc = грамодіск
grandeur = грандұр
grandma = грамма
grandpappy = гранд¬папі
grandpa = грампа
grandsons = гранд¬сѵннес
grandson = гранд¬сѵнн
granturco = грантѵрко
gravjumper = грав¬жѵмпер
grayer = грејер
grayish = грејіш
grayshott = грејшот
grazzy = гразі
gra = гра
grd = грд
greater = грејтер
greatest = грејтест
greatness = грејтнесс
great = грејт
greaves = гріјвес
greave = гріјв
greenwich = греніч
green = грєн
gree = грє
gresha’s = греша-с
gresha = греша
greyer = грејер
greyhounds = грејхаундес
greyhound = грејхаунд
gridex = грідекс
grievin = грєвін
grinny = гріні
groats = грөтес
groat = грөт
groggily = грогілі
gromky = громкі
groodies = грудіес
groody = груді
groundcar = граундкар
groundside = граундсид
groun = гроѵн
grouter = граутер
groweth = гроуþ
growin = гроуін
growwwwowwwwowwww = гроууууоууууоуууу
grrrrr = гррррр
grrr = гррр
gruppas = групаес
g’s = г-с
guaranteed = гӕрантіјед
guardcar = гардкар
guardsman = гардсман
guardsmen = гардсмен
guar = гуар
guerrilla = геріла
guessed = гессед
guesses = гессес
guessing = гессінг
guess = гесс
guffs = гѵфес
guildsman’s = гілдсман-с
guildsman = гілдсман
guildsmen = гілдсмен
guiltier = гілтіер
guitars = гітарес
guitar = гітар
gurgled = герглед
gurgles = герглес
gurgles = герглес
gurgle = гергл
gurgle = гергл
gurgling = герглінг
gutenberg’s = гутенберг-с
guttiwuts = гѵтіуѵтес
guys = гајес
guy = гај
gwarrr = гуаррр
gymnosperms = жімноспермес
gymnosperm = жімносперм
gyroed = жирөед
g = г
habbanya = хабанја
habibullah = хабібула
hacket = хакет
haderach = хадерак
hadn’t = хад-нт
hagal = хагал
hahaha = хахаха
haiiiii = хаііііі
hailed = хејлед
hailie = хејлі
hailing = хејлінг
hails = хејлес
hail = хејл
haints = хӕнтес
hain’t = хеј‑нт
hairdos = хејр¬дуес
hairdo = хејр¬ду
hairdressed = хејрдрессед
hairdresses = хејрдрессес
hairdressing = хејрдрессінг
hairdress = хејрдресс
hair’d = хејр-д
haired = хејред
hairless = хејрлесс
hairline = хејрлин
hairs = хејрес
hairy = хејрі
hair = хејр
hai = хај
hajra = хажра
hajr = хажр
hakama = хакама
halfoak = хафөк
halleck’s = халек-с
hallelujah = халелуја
hallos = халоуес
hallo = халоу
hallucinant = халұцінант
halmyn = халмін
hamlit = хамліт
handbeam = хандбєм
handfuls = хандфѵлес
handful = хандфѵл
handkerchiefs = ханкерчєфес
handkerchief = ханкерчєф
handlaser = хандлӕзер
handprint = хандпрінт
hands’re = хандес-р
haneker = ханекер
hangin = хангін
háni = ха́ні
hankerin = ханкерін
hanolon = ханолон
haori = хаорі
haploids = хаплоідес
happenin = хапенін
harah’s = хараа-с
harah = хараа
harappa = харапа
harbicides = хербіцидес
harbicide = хербіцид
harbivores = хербіворес
harbivore = хербівор
harbivorous = хербіворос
hardfax = хардфакс
hardsuits = хардсұтес
hareem = харєм
hargpass = харгпас
harj = харж
harkonnens = харконенес
harkonnen = харконен
harkon = харкон
harko = харко
harmonthep = хармонþеп
harq = харк
harrumm = харѵм
haruhi’s = харухі-с
haruhi = харухі
haru’s2 = хару-с
haru’s = хару-с
haru = хару
hasbol = хасбол
hasimir = хасімір
hasmonean = хасмонеан
hasn’t = хас-нт
hasta = аста
has = хас
hauwwww = хаѵѵѵѵѵ
hauwww = хаѵѵѵѵ
hava = хава
haven’t = хав-нт
haverfords = хеверфордес
havin = хавін
hawat’s = хауат-с
hawat = хауат
hawhawhaws = хауауаус
haye = хеј
haystack = хејстак
headaches = хед¬ӕкес
headache = хед¬ӕк
headcloth = хед¬клоþ
headdress = хед¬дресс
head’s2 = хед-с
headsman’s = хедсман-с
headsman = хедсман
healed = хіјлед
healing = хіјлінг
heals = хіјлес
heal = хіјл
hearings = хірінгес
hearing = хірінг
hearplugs = хірплѵгес
hearplug = хірплѵг
hearses = херсес
hears = хірес
heartiness = хартінесс
hear = хір
heavenmetal = хевенметал
hebron’s = хєброн-с
he’da = хє‑да
he’d = хє-д
heere = хєр
hegemony’s = хежемоні-с
heian = хејан
heighliners = хејлинерес
heighliner = хејлинер
heightener = хејтенер
heighths = хејþес
heighty = хӕті
heigh = хеј
heinicke = хиніке
heisenberg = хајзенберг
hekiganshu = хекіганшу
helenda’s = хеленда-с
helenda’s = хеленда-с
helenda = хеленда
helenda = хеленда
hellas = хелас
hella = хела
hello = хелоу
hellwhips = хелуіпес
hellwhip = хелуіп
he’ll = хє-л
helmholtz’s = хелмхөлтц-с
helmholtz = хелмхөлтц
helplessly = хелп­лес­лі
helpless = хелп­лесс
hemorrhaged = хеморажед
hemorrhages = хеморажес
hemorrhage = хемораж
hemorrhaging = хеморажінг
hence = хенс
herbal = хербал
herbs = хербес
herb = херб
herdmates = хердмӕтес
heremis = хєрміс
here’re = хєр-р
here = хєр
herkneth = херкнеþ
hermeneutics = херменеѵтікес
heroism = херөізм
herself = херселф
hers = херес
her = хер
he’s = хє-с
het = хет
he’ve = хє-в
hexaperson = хексаперсон
heyaaaaas = хејааааас
heya = хеја
heyo = хејо
hhrghn = ххргхн
hiccoughed = хікѵпедінг
hiccoughing = хікѵп
hiccoughs = хікѵпес
hiccough = хікѵп
hidin = хидін
hiereg = хіeрег
hieroglyphic = хиерогліфік
highballs = хајболес
highball = хајбол
highborns = хајборнес
highborn = хајборн
higher = хај¬ер
highest = хај¬ест
highfaluting = хајфалұтінг
highlands = хај¬ландес
highland = хај¬ланд
highly = хајлі
highness’s = хај¬несс-с
highness = хајнесс
highways = хајуејес
highway = хајуеј
high = хај
hikawa = хікауа
hikman = хікман
himbo = хімбо
hindu = хінду
hin = хін
hipped = хіпед
hipswing = хіпсуінг
his’n = хіз’н
historied = хісторіед
his = хіз
hmmm = хмм
hmm = хмм
hmph = хмф
hmp = хмп
hm = хм
hnnrh = хннрх
hoarsely = хоурслі
hoarse = хоурс
hoax = хөакс
hobbits = хобітес
hobbit = хобіт
hoeing = хоуінг
hogleg = хоглег
hog’s = хог-с
hogtied = хог¬тајед
hogties = хог¬тајес
hogtie = хог¬тај
hogtying = хог¬тајінг
hohenstaufen = хоенштауфен
hohohohoho = хөхөхөөхө
hohoho = хөхөхө
holds = хөлдес
hole = хөл
holie = хөлі
holinight = холінит
holjance = холжанц
hollered’n’kicked’n’fought = холеред-н-кікед-н-фаѵт
hollerin = холерін
holodisks = холодіскес
holodramas = холодрамаес
holodrama = холодрама
holopit = холопіт
holoscan = холоскан
holosculpture = холоскѵлптұр
holos = холоес
holo = холо
höltzer = холтсер
homecomps = хөм¬компес
homefree = хөм¬фріј
homesystem = хөм¬сістем
homes = хөмес
homeways = хөмуејес
home = хөм
homosexual = хөмосексұал
honeying = хѵніінг
honey = хѵні
honnete = хонете
honno = хонно
hookman = хукман
hoolie = хулі
horrorshow = хороршоу
horse’s = хорс-с
hor = хор
hougoumont = угумон
hounslow = хаунеслоу
hourglasses = ауергласес
hourglass = ауерглас
houris = хуріес
houri = хурі
hourly = ауерлі
hours = ауерес
hour’s = ауер-с
hour = ауер
hova = хова
hoverfans = хѵверфанес
hovertank = хѵвертанк
how’d = хау-д
however = хау¬евер
howl’s = хаул-с
howly = хаулі
how’re = хау-р
how’s = хау-с
hoyt’s = хојт-с
hq = хк
h’rm = хрм
hrobas = хробас
hrobosa = хробоса
hrothgar’s = хроþгар-с
hrothgar = хроþгар
hrrgnn = хрргнн
hrrmph = хррмф
hrrrmph = хрррмф
hsishuang = сішуанг
hs = хс
htn = хтн
htv = хтв
huddlings = хѵдлінгес
hues = хеѵес
hue = хеѵ
hufuf = хуфуф
hulud’s = хулуд-с
hulud = хулуд
humanoid = хұманоід
humphed = хѵмфт
humphing = хѵмфінг
humph = хѵмф
hunner = хѵнер
hurled = херлед
hurling = херлінг
hurls = херлес
hurl = херл
hurricanes = хѵрікенес
hurricane = хѵрікен
hurriedly = хѵріедлі
hurried = хѵріед
hurries = хѵріес
hurrying = хѵріінг
hurry = хѵрі
hurted = хертед
hurtfulness = хертфѵлнесс
hurting = хертінг
hurts = хертес
hurt = херт
husbands = хѵсбандес
husband = хѵсбанд
huuuh = хѵѵѵ
hyakunin = хјакунін
hya = хја
hydrocyanic = хидроцианік
hymnbooks = хімн¬букес
hymns = хімнес
hymn = хімн
hyne = хин
hyoutan = хјоутан
hyperbole = хипер¬боле
hyperions = хиперіонес
hypnology = хіпноложі
hypnopaedia = хіпнопєдіа
hypnopædia = хіпнопєдіа
hypnopædia = хіпнопєдіа
hypnopædically = хіпнопєдіклі
hypnopædic = хіпнопєдік
hypnostudy = хіпностѵді
hypnotised = хіпнотизед
hypno = хіпно
hyrier = хиріер
h = х
iakin = іакін
iam = иам
ibad = ібад
ibar = ібар
iblis = ібліс
ibm = ібм
icebergs = исбергес
iceberg = исберг
icebox = ајсбокс
iced = исед
icefields = ис¬фєлдес
icefield = ис¬фєлд
icelandic = исландік
iceland = исланд
ices = исес
ice = ис
ichwan = ічуан
icing = исінг
icy = исі
i’da = и‑да
idealists = идєалістес
idealist = идєаліст
ideals = идєалес
ideal = идєал
ideas = идєаес
idf = ідф
idiomatically = ідіоматіклі
idlewilds = идлуилдес
i’d’ve = и-д-в
i’d = и-д
id = ид
ier = иер
ii = ii
iii = iii
ikhut = ікхут
illtraming = ілтрӕмінг
illyla = ілила
i’ll = и-л
ilm = ілм
ima = има
imperium = імпєріѵм
impetuouth = імпєтұоþ
implosionist = імплөзіоніст
i’m = и-м
includin = інклұдін
indefatigably = індефатігаблі
indelibies = інделібіес
indicted = індитед
indicting = індитінг
indicts = індитес
indict = індит
indifferent = індіферент
indigenies = індіжєніес
indigenie = індіжєні
indio = індіо
indoors = індорес
inexplicable = ін¬екс¬плікабл
infinitus = інфінітѵс
inf = інф
ingary = інгарі
inglo = інгло
ingsley’s = інгслі-с
ingsley = інгсеі
initiates = ініціӕтес
inkvine = інквин
inns = іннес
innumerable = інұмерабл
inn = інн
insectoid = інсектојд
instinctual = інстінктұал
instrument = ін¬стрѵ¬мент
insurance = іншұранц
intellectually = інтелектұаллі
intentions = інтенціонес
intention = інтенціон
interactives = інтерактівес
interessovatted = інтересоватед
interested = інтерестед
interesting = інтерестінг
interesting = інтерестінг
interestin = інтрестін
interests = інтерестес
interest = інтерест
interknowledge = інтеркнолеж
interrogated = інтӕрогӕтед
interrogation = інтерогӕціон
interrogative = інтерогатів
interrogators = інтерогӕторес
interrogator = інтерогӕтор
interrupted = інтерѵптед
interrupting = інтерѵптінг
interruption = інтерѵпціон
interrupts = інтерѵптес
interrupt = інтерѵпт
interviewees = інтервеѵєес
interviewee = інтервеѵє
interviews = інтервеѵес
interworld = інтреруерлд
intinfmin = інтінфмін
into = інто
intravenally = інтравєналлі
intravenals = інтравєналес
intrigued = інтрігед
intrigues = інтрігес
intrigue = інтріг
intriguing = інтрігінг
int = інт
invaluably = інвалұаблі
inviolated = інвиолӕтед
inviolates = інвиолӕтес
inviolate = інвиолӕт
inviolating = інвиолӕтінг
’in = ’ін
iodoacetate = иодоацетӕт
ionosphere’s = ионосфер-с
io = іо
irked = еркед
irking = еркінг
irks = еркес
irk = ерк
irl = ірл
ironed = иернед
ironing = иернінг
irons = иернес
iron = иерн
irrelevant’n’immaterial = іррелевант-н-іматеріал
irulan = ірулан
ir = ѵр
isaac = изак
isbn = ісбн
ishizaki = ішізакі
islamic = ісламік
isn’t = іс-нт
israeli = изрӕелі
israel = изрӕел
issaac = изак
isshu = ішшу
issued = ісұед
issues = ісұес
issue = ісұ
issuing = ісұінг
iss = ісс
istislah = істіслах
is = іс
it’s = іт-с
its = ітс
ittara = іттара
itta = ітта
ittied = ітіед
itties = ітіес
ittying = ітіінг
it’ud = іт-д
iu = іу
ivanhoe = иванхоу
i’ve = и-в
iv’s = ив-с
iv = ив
iwill = иуіл
ixian = іксіан
ix = ікс
iyathtokyai = іјаþтокјаі
i = и
jacktown’s = жактаун-с
jacktown = жактаун
jacques = жак
jamaican = жамӕкан
jamaica = жамӕка
jamis’ll = жӕміс-л
jamis = жӕміс
jammiwam = жаміуам
jamnu = жамну
jasmium = жасміум
jaws = жаѵес
jbw = жбу
jealousy = желосі
jedge = жеж
jeems = жємес
jeeznies = жізніес
jeezny = жізні
jehosaphat = жехосафат
jem’d = жем’д
jem’n = жем’н
jerry = жері
jetboat = жетбөт
jetflares = жетфлӕрес
jewe = жеѵе
jews = жеѵес
jew’s = жеѵ-с
jew = жеѵ
jibvines = жібвинес
jinglejangling = жінглжанглінг
jingu = жінгу
jinsane = жінсӕн
jiri’s = жірі-с
jiro = жіро
jist = жіст
jiten = жітен
joan2 = жоан
johnnies = жоніес
jojohn = жожон
jokin = жөкін
jongg = жонг
jonny = жоні
josifa = жосіфа
journeys = жѵрніес
journey = жѵрні
jubba = жуба
jubilantly = жұбілантлі
jubilant = жұбілант
jubilee = жұбіліј
judo = жудо
jugoslav = југослав
juicily = жұіцілі
jumpcab = жѵмп¬каб
jumpships = жѵмпшіпес
jumpship = жѵмпшіп
juries = жұріес
jurymen = жұрімен
jury’s = жұрі-с
jury = жұрі
jus’ = жѵс-
juvie = жуві
j = ж
kaba = каба
kaen = каен
kaifa = кајфа
kaising = кајсінг
kaitain = кајтајн
kaleff = калеф
kalima = калима
kali = калі
kamavas = камавас
kanezane = канезане
kangsar = кангсар
kanly = канлі
kans = канес
kaoru = каору
kapry = капрі
karakoram = каракорам
karama = карама
karaoke = кӕраөке
kara = кара
karno’s = карно‑с
karres = карес
kartoffel = картофел
karuta = карута
kashl = кашл
kassad’s = касад-с
kassad = касад
kassd = касд
kastrop = кастроп
katakana = катакана
kautman = каутман
kavi = кави
keate = кєт
keatsish = кєтесіш
keats’s = кєтес-с
keelroots = кєлрутес
keelroot = кєлрут
keeshkas = кішкаес
kermode = кермөд
keroids = керојдес
kerosene = керосєн
kerris = керіс
ketering = кєтерінг
ket = кет
keyboard = кіјборд
keyed = кіјед
keyholes = кіјхөлес
keyhole = кіјхөл
keys = кіјес
key = кіј
k’far = к’фар
khaki’s = какі-с
khala = кхала
kiai = кіаі
kiakimé’s = кіакімé-с
kiakimé = кіакімé
kiakimé = кіакіме
kiathla = кіаþла
kibitzing = кібітцінг
kiddo = кідо
kierkegaard’s = кіркегард-с
kierkegaard = кіркегард
kilogrammes = кілограмес
kilograms = кілограмес
kilometers = кіло¬мєтрес
kilometers = кіломєтрес
kilometer = кілометр
kilometer = кіло¬мєтр
kilometres = кілометрес
kilometres = кіло¬мєтрес
kilometre = кілометр
kilometre = кіло¬мєтр
kimono = кімоно
kind’d = кинд’д
kindjals = кінжалес
kindjal = кінжал
kindlin = киндлін
kinet’s = кинет-с
kinet = кінет
kingsbury = кінгесбӕрі
kinjiro = кінжіро
kinkin = кінкін
kinna = кіна
kinshi = кінші
kinsman = кінсман
kinsmen = кінсмен
kiswa = кісуа
kitab = кітаб
kiti = кіті
kiva = ківа
kiyoodling = кіјудлінг
klatha = клаþа
kleb = клеб
klicks = клікес
klootch = клуч
klux’s = клѵкс‑с
kneaded = ніјдед
kneading = ніјдінг
kneads = ніјдес
knead = ніјд
knew = кнеѵ
knify = нифі
knights = книтес
knight = книт
knobbily = нобілі
knockies = нокіес
knockiknockiknock = нокінокінок
knockknock = нокнок
knocky = нокі
knopka = нопка
knotholes = кнотхөлес
knothole = кнотхөл
knots = кнотес
knot = кнот
knowed = кноуед
knowest = кноуест
knowing = кноуінг
knowin = кноуін
knowledgeful = кнолежфѵл
knowledge = кнолеж
known = кноун
knows = кноуес
knowwho = кноуху
know = кноу
kofun = кофун
kohakwa = кохакуа
koizumi = коізумі
koke = коке
koma = кома
koneywell = коніуел
koosh = куш
kopat = копат
korenja = коренжа
korm = корм
koromo = коромо
korova = корова
koshkas = кошкаес
koshka = кошка
kothlu = коþлу
kothlu = коþлұ
kots = котес
kourbash = курбаш
kowa’s = коуа-с
kowa’s = коуа-с
ko = ко
kraaaaark = крааааарк
kresten = крестен
krimskell = крімскел
kristus = крістѵс
krovvy = крові
krrwarr = крруарр
kudu = куду
kuentsing = куентсінг
kujo = кужо
kulab = кулаб
kuni = куні
kupetted = купетед
kupetting = купетінг
kupet = купет
kurfurstendamm = курфурстендам
kushpat = кушпат
kushti = кушті
kuyoh = кујоу
kwisatz = куісатц
kwleert = кулєрт
kyami = кјамі
kyam = кјам
kynes = кинес
kynes = кинс
kyon’s = кјон-с
kyon = кјон
k = к
labeled = лӕблед
labeling = лӕблінг
labelled = лӕблед
labelled = лӕблед
labelling = лӕблінг
labels = лӕблес
label = лӕбл
labour = лӕбор
labrynthine = лабрінþін
labyrinths = лабірінþес
lackweight = лак¬уејт
lacquer = лакер
ladder’d = ладер-д
ladies’d = лӕдіес’д
lad’s = лад-ес
lad’s = лад-с
laided = лејдед
laiding = лејдінг
laids = лејдес
laid = лејд
laid = лејед
lained = лејнед
laining = лејнінг
lains = лејнес
lain = лејн
laissez = лесе
lambents = ламбентес
lambs = ламес
lamb = лам
lamia’s = ламіа-с
lamia = ламіа
lamprey’s = лампрі-с
lamprey = лампрі
landsraad’s = ландсрад-с
landsraad = ландсрад
languages = лангуажес
language = лангуаж
langues = лангес
lankavatara = ланкаватара
lankiveil = ланківӕл
laocoön = лаокоон
laoco = лаоко
laoco = лаоко
laoujin = лаоужін
lardy = ларді
largesse = ларжесс
larrigan = ларіган
larus = ларѵс
lasbeams = ласбємес
lasguns = ласгѵнес
lasgun = ласгѵн
’later = ’лӕтер
latht = лаþт
laughin = лафін
laughlin = лаѵклін
laughs = лафес
lavastone = лавастөн
lavations = лӕвӕціонес
lawin = лаѵін
laws = лаѵес
layabouts = лејабаутес
layabout = лејабаут
layered = лејеред
layers = лејерес
layer’s = лејер-с
layer = лејер
layin = лејін
layman = лејман
laymen = лејмен
layouts = леј¬аутес
layout = леј¬аут
leached = ліјчед
leaches = ліјчес
leaching = ліјчінг
leach = ліјч
lead1 = лед
lead2 = лєд
leads1 = ледес
leads2 = лєдес
lead’st = лєд-ст
lead = лєд
leaguers = лєгерес
leaked = ліјкед
leaking = ліјкінг
leaks = ліјкес
leak = ліјк
leaned = ліјнед
leaning = ліјнінг
leanin = ліјнін
leans = ліјнес
leant = лент
lean = ліјн
leas = ліјес
leavin = ліјвін
lea = ліј
lectors = лекторес
leechweed = лєчуєд
leeda = лєда
leewit = лєуіт
legged = легед
legions = лєжіонес
legion = лєжіон
leisurely = лєзұрлі
leisure = лєзұр
leis = лејс
lelaundel = лелаѵндел
lele = леле
lemil = леміл
lenar = ленар
lengths = ленгþес
lenina’s = леніна-с
lenina = леніна
lenista = леніста
lenoir = ленуар
leonardo = леонардо
leotards = лєотардес
lepidopterist = лепідоптеріст
lepti = лепті
lethe’s = лєþе-с
lethe = лєþе
leto’s = лето-с
leto’s = лето-с
leto = лето
letties = летіес
lettie’s = леті‑с
lettin = летін
lewdies = лұдіес
leweski = левескі
leweski = левескі
leycoils = леј¬којлес
liars = лајерес
liar = лајер
liban = лібан
lice = лис
lickturned = ліктѵрнед
lidded = лідед
lieth = лајþ
liet’s = ліет-с
liet = ліет
lightmans = литманес
lightnin = литнін
likeness = ликнесс
lilywhite = ліліуит
limbs = лімес
lincolnesque = лінкенеск
lincoln = лінкен
lingar = лінгар
linin = линін
linna = ліна
liny = лині
lipmusic = ліпмұзік
lisan = лісан
listenin = лісенін
litany’s = литані-с
literalness = літералнес
literjons = літержонес
literjon = літержон
litsos = літсоес
litso = літсо
little’uns = літл-ѵнес
live1 = лив
live2 = лів
lived = лівед
lives1 = ливес
lives2 = лівес
live = лів
lizardlike = лізардлик
llewela = леѵела
’ll = -л
’ll = -л
ll = л
loaded = лөдед
loading = лөдінг
loads = лөдес
load = лөд
loathed = лөþед
loathes = лөþес
loathe = лөþ
loathing = лөþінг
loathsomeness = лоуþcѵмнесс
loathsome = лоуþcѵм
loath = лөþ
lockrings = локрінгес
lodovico = лодовіко
loggies = ложіес
lomticks = ломтікес
lomtick = ломтік
longdrawn = лонгдраѵн
longer’n = лонгер’н
long’ll = лонг-л
longnose = лонгнөз
’long = ’лонг
looka = лука
lookin = лукін
los = лос
louse = лаус
lovedeath = лѵвдеþ
loveted = ловетед
lovet = ловет
loyt = лојт
l’s = л-ес
lubbilubbing = лѵбілѵбінг
lubbilub = лѵбілѵб
lucrezia = лукретціа
ludgate = лѵдгӕт
ludovico’s = лудовіко‑с
ludovico = лудовіко
lunchboxes = лѵнчбоксес
lungpipes = лѵнгпипес
lungpipe = лѵнгпип
lunkheaded = лѵнк¬хедед
luoyang = луојанг
lupton’s = лѵптон-с
lured = лұред
lures = лұрес
lure = лұр
luring = лұрінг
lusians = лұзіанес
lusian = лұзіан
lusus’s = лұзѵс-с
lusus = лұзѵс
luteum = лұтеѵм
luxury = лѵксұрі
lycius = ліціѵс
lyin = лајін
lyrae = ліре
lyrd = лѵрд
ly = лі
l = л
m2 = м2
m5 = м5
maaaaaaah = маааааааа
maaaybe = мееејбє
ma’amin = мамін
ma’am = мам
madelwud = мӕделуѵд
madhya = мадхја
mad’s = мад-с
magclamps = магклампес
magician’s = мажіціан-с
magritte’s = магріт-с
magritte = магріт
maided = мејдед
maiding = мејдінг
maids = мејдес
maid = мејд
mailed = мејлед
mailing = мејлінг
mails = мејлес
mail = мејл
mained = мејнед
maining = мејнінг
mains = мејнес
main = мејн
mairu = мајру
maizeed = мејзед
maizeing = мејзінг
maizes = мејзес
maize = мејз
makemake = макемаке
maketh = мӕкеþ
malchickies = малчікіес
malchickiwicks = малчікі¬уікес
malchickiwick = малчікі¬уік
malchicks = малчікес
malchick = малчік
malenky = маленкі
mallarmé = маларме
malorientation = малоріентӕціон
malpais = малпаіс
manager’s = манажер-с
manaret = манарет
mandellin = манделін
manicholo = манічоло
mansions = мансіонес
mansize = мансиз
mansoor = мансур
mantalike = манталик
mantene = мантене
manual’s = манұал-с
maometh = маомеþ
mapes = мапес
mappy = мапі
mapsats = мапсатес
mare2 = маре
marghanita = марганіта
margoli = марголі
mari’s = марі-с
marksmanship’s = марксманшіп‑с
marne = марн
marquesas = маркезаес
marquesas = маркезас
marriages = мӕріажес
marriage = мӕріаж
married = мӕріед
marries = мӕріес
marrrrre = маррррр
marrying = мӕріінг
marry = мӕрі
marsailema = марсаілема
marshi = марші
mars = марс
marx’s = маркс-с
masada = масада
mashad = машад
mashhad = машхад
maskies = маскіес
maskie = маскі
maslo = масло
masseuse = масұз
masteen’s = мастєн-с
masteen = мастєн
maste = масте
ma’s = ма‑с
mátaski = ма́таскі
matriculators = матрікұлӕторес
mátsaki = ма́тсакі
mattai = матај
matthewmonth = матеѵмѵнþ
maula = маула
maybe = мејбє
maycombian = мејкөміан
maycomb’ll = мејкөм‑л
maycomb’s = мејкөм‑с
maycomb = мејкөм
mayco = мејко
mayella’s = мејела‑с
mayella = мејела
mayellerin = мејелерін
mayflower = меј¬флауер
mayhap = мејхап
mayor’s = мејор-с
mayor = мејор
mayst = мејст
may’ve = меј-в
mcbee’s = мак-біј-c
mcbee = мак-біј
mckyler = мак-кајлер
mckyler = мак-кајлер
m’costume = м-костұм
md = мд
meaning = міјнінг
means = міјнес
mean = міјн
measures = мезұрес
meat = міјт
mebbe = мебе
mebeckey = мебекі
mechanically = меканіклі
mechs = мекес
mech’s = мек-с
medcom = медком
medevacked = медевакед
medicinals = медіціналес
medicinal = медіцінал
medieval = медієвал
mediterranean = ме­ді­те­рӕ­неан
medkits = медкітес
medkit = медкіт
medoirian = медоіріан
medscanner’s = медсканер-с
medscanner = медсканер
medscans = медсканес
medscan = медскан
me’d = мє’д
megadatasphere = мегадӕтасфєр
megan’s = меган-с
megan = меган
meina = мејна
melange = меланж
mêlée = меле
melee = мелеј
melio = мєліо
melodia = мелодіа
memorie’s = меморі-с
mending’s = мендінг-с
mentats = ментатес
mentat’s = ментат-с
mentat = ментат
me’n = мє’н
mercantiles = меркантилес
merde = мерд
merde = мерде
merega = мерега
merin’s = мерін-с
merin = мерін
merisco = меріско
merriweather’s = меріуеþер‑с
merry = мері
merzky = мерзкі
mesa = меса
messiahs = месиаес
messin = месін
mestos = местоес
mesto = место
me’s = мє‑с
metacortex = мєтакортекс
metaglass = мєтаглас
metaknowledge = мєтакнолеж
metaphors = метафорес
metaphor = метафор
metcha = меча
metcha = меча
meteors = мєтеорес
meteor = мєтеор
meter2 = мєтер # counter
meters = мєтрес
meter = мєтр
metres = мєтрес
metre = мєтр
mf = мф
m’hat = м-хат
mice = мис
michael’s = микел-с
michael = микел
microanalysis = микро¬аналісіс
microdisk = микродіск
microleads = микролєдес
microscanner = микро¬сканер
microseconds = микросекондес
microsecond = микросеконд
microspores = микроспорес
microswitch = микросуіч
midsump = мідсѵмп
miffel = міфел
mighta = мајта
mightn’t = мајт-нт
mighty = мајті
might = мајт
mihna = міна
miko = міко
millicents = міліцентес
millimeters = мілі¬мєтрес
millimeter = мілі¬мєтр
millimetres = мілі¬мєтрес
millimetre = мілі¬мєтр
minder’s2 = миндер-с
minetti = мінеті
minimic = мінімік
minootas = мінутаес
minoota = мінута
minutiae = мінұціе
minutia = мінұціа
miragelike = міражлик
mirth = мерþ
miscarriages = міскӕріажес
miscarriage = міскӕріаж
mischief = місчіф
mischievous = місчівос
miseces = місецес
miserer = мізерер
misere = мізер
misfigured = місфігұред
misr = міср
missionaria = місіонаріа
mis’sippi = міс’сіпі
mithal = міþал
mitha = міþа
mitsima’s = мітсіма-с
mitsima = мітсіма
miz = міз
mk = мк
m’lady = м-ладі
mlles = мллес
m’load = м-лөд
m’lord = м-лорд
mmmm = мммм
mmm = ммм
m’name = м-нӕм
mnemonics = мнемонікес
mnemonic = мнемонік
mnemosyne = мнемосіне
moander = моандер
moated = мөтед
moats = мөтес
moat = мөт
möbius = мобіѵс
mochi = мочі
mockin = мокін
modulated = модұлӕтед
moe = мое
mohiam = мохіам
mojave = мохаве
molodoy = молодој
moloko = молоко
molotov = молотов
mondays = мѵндејес
monday = мѵндеј
mond’s = мөнд-ес
mond = мөнд
moneta’s = монета-с
moneta = монета
monofilaments = мөнофіламентес
monsters = монстрес
monster = монстр
mons = монес
montgomery = монтгѵмері
moodges = мужес
moodge = муж
mooorrre = моооррр
moors = мурес
morbius = морбиѵс
morbius = морбіѵс
more’n = мор-н
morgana’s = моргана-с
morgana = моргана
moritani = морітані
morphodite = морфодит
mortgaged = моргӕжед
mortifyin = мортіфајін
morula = морұла
moseyin = мөзјін
moshé = моше
moted = мөтед
motherschool = мѵþерскул
moue = му
mounch = маунч
mountsyubi = маунтсјубі
mourned = моурнед
mourners = моурнерес
mourner = моурнер
mournfully = моурн¬фѵллі
mournful = моурн¬фѵл
mourning = моурнінг
mourns = моурнес
mourn = моурн
movin = мувін
mowlers = моулерес
mozart’s = мотсарт-с
mozart = мотсарт
mozg = мозг
mo = мо
mperial = мперіал
mps = мпс
mri = мри
mrrrarr = мрррарр
mrrrowrr = мррроурр
mrs = мрс
mrunas = мрѵнаес
mrunas = мрѵнас
mr = мр
m’self = м-селф
m’shoes = м-шуес
ms = мс
mt = мт
muad’dib’s = муаддіб-с
muad’dib = муаддіб
muadh = муадх
mudflats = мѵдфлатес
mudflat = мѵдфлат
mudir = мудір
mudquake = мѵдкуӕк
mudye = мѵдје
muhaiwir = мухајуір
muir’s = мұр-с
muir = мұр
mullahs = мулаес
mullah = мула
multichannel = мѵлтічанел
multihued = мѵлтіхеѵед
multimorphs = мѵлті¬морфес
multiport = мѵлтіпорт
multishelled = мѵлтішелед
multitudinous = мѵлтітұдінос
multiworld = мѵлтіуерлд
munchmunching = мѵнчмѵнчінг
murdered = мердеред
murdering = мердерінг
murderous = мердерос
murders = мердерес
murder = мердер
murky = меркі
murk = мерк
murmured = мѵрмѵред
murmuring = мѵрмѵрінг
murmurous = мѵрмѵрос
murmurs = мѵрмѵрес
murmur = мѵрмѵр
muscles = мѵслес
muscle = мѵсл
mushtamal = муштамал
mustapha = мустафа
musta = мѵста
mustn’t = мѵст-нт
must’ve = мѵст-в
mutts = мѵтес
muzziness = мѵзінесс
mv = мв
mwa = муа
mw = му
mycenae = мицєне
myrie = мірі
mysclub = місклѵб
mythography = міþографі
mythohistorian = міþохісторіан
mythos = міþос
my = ми
’m = -м
m = м
naaow = нааоу
nachinatted = начінатед
nachinat = начінат
nadmenny = надмені
nadsats = надсатес
nadsat = надсат
nagato = нагато
naga = нага
nagilla = нагіла
nagoy = нагој
nahya = нахја
naiad = најад
naib = најб
naivete = наівете
naïveté = наівете
naïveté = наівете
naive = наів
naïve = наів
nakalas = накалаес
nakelas = накелас
nama = нама
nambe = намбе
nanda = нанда
nans = нанес
naoko = наоко
nao = нао
naptime = наптим
narated = нарӕтед
narates = нарӕтес
narate = нарӕт
narations = нарӕціонес
naration = нарӕціон
narative = наратів
narcal = наркал
narcolept = нарколепт
narrators = нарӕторес
narrator = нарӕтор
narrowed = нероуед
narrowing = нероуінг
narrows = нероуес
narrow = нероу
narviium = нарвііум
narvi = нарві
nar = нар
natchell = начел
nathty = наþті
nauseated = наѵзеӕтед
nauseates = наѵзеӕтес
nauseate = наѵзеӕт
nauseating = наѵзеӕтінг
nausea = наѵзеа
navachristianity = навакрістіаніті
nazis = натціес
nazi = натці
nazz = наз
ná = на́
nda = нда
neanderthals = неандерþалес
neanderthal = неандерþал
nearby = нєрби
nections = некціонес
needn’t = нєд-нт
neezhnies = ніжніес
nefud’s = нефуд-с
nefud = нефуд
negligee = негліже
nehi = нєхи
neighbored = нӕборед
neighborhoods = нӕборхудес
neighborhood = нӕборхуд
neighboring = нӕборінг
neighbors = нӕборес
neighbor = нӕбор
neldo = нелдо
nematodic = нематодік
nembi = нембі
nephews = нефеѵес
nephew = нефеѵ
nervature = нерватұр
nervousness = нервоснесс
neshou = нешу
neural = неѵрал
neurological = неѵроложікал
neuron = неѵрон
neuron = неѵрон
neurotic = неѵротік
neuro = неѵро
newly = неѵлі
newspapers =  неѵес­пӕ­перес
newspaper =  неѵес­пӕ­пер
newsteeps = неѵестєпес
newsteeps = неѵстєпес
newsteep = неѵестєп
newsteep = неѵстєп
news =  неѵес­
new = неѵ
nezhoni = нежоні
nicety = ницті
niche = ніш
nigger’d = нігер’д
nightbirds = нитбердес
nightbird = нитберд
nightbugs = нитбѵгес
nightenhelser = нитенхелсер
nightmares = нит¬мӕрес
nightwise = нитуиз
’night = ’нит
nig = ніг
nihil = ніхіл
nikaido = нікајдо
niki’s = нікі-с
niki = нікі
nikkeldepain = нікелдепејн
nikkerliss = нікерліс
nimbleness = німблнесс
niner’s = нинер-с
ninetieth = нинтіþ
nisai = нісај
nishiya = нішіја
niushe = ніуше
no2 = но
nobodies = нөбодіес
nobody’d = нөбоді-д
nochy = ночі
nogas = ногаес
noga = нога
noisy = ноізі
nomu = ному
noncolony = нонколоні
nondialect = нондиалект
nonerasable = нон¬ерӕзабл
none’s = нѵн‑с
nonfactorable = нонфакторабл
nonharmonic = нонхармонік
nonprofound = нонпрофаунд
nontotal = нонтөтал
nonvital = нонвитал
nooky = нукі
nooo = нөөө
noo = ну
nordholm = нордхолм
northcountry = норþкѵнтрі
northeastern = норþ¬єстерн
northerlies = норþерліес
northwards = норþ­уардес
noseless = нөзлесс
nosily = нөзілі
nostalgia = носталжіа
nothin’s = нѵþін‑с
nothin = нѵþін
notin = нотін
notobe = нотобе
not’s = нот‑с
nottobe = ноттобе
not’ve = нот-в
noukkers = нуукерес
noumm = ноумм
novelizations = новелізаціонес
nowhere = нөуӕр
nozhes = ножес
nozh = нож
no = нө
nra = нра
nrl = нрл
n’s = н-ес
n’t = -нт
nuclear = нұклеар
nuked = нұкед
nuking = нұкінг
nullgrav = нѵл¬грав
nuris = нуріес
nuri = нурі
nursed = нерсед
nurseries = нерсеріес
nursery = нерсері
nurses = нерсес
nurse’s = нерс-с
nurse = нерс
nursing = нерсінг
nyan = нјан
ny = нј
’n = ’н
n = н
o5 = о5
oakdale = өкдӕл
oaks = өкес
oak = өк
oats = өтес
oat = өт
obeah = өбеа
obeg = обег
obeyed = обејед
obeying = обејінг
obeys = обејес
obey = обеј
obi = обі
obnoxiously = обноксіослі
obnoxious = обноксіос
obscenely = обсцєн¬лі
obscurely = обскұрлі
occam = окам
occured = окѵред
occuring = окѵрінг
occurred = окѵред
occurrence = окѵренц
occurring = окѵрінг
occurs = окѵрес
occur = окѵр
oceangoing = ө¬ціан¬гоу¬інг
ocher = окер
o’clock = о-клок
ocs = окс
ocs = өкс
oda2 = ода
odds = одес
oed = оед
oeyh = оеј
offa = офа
offworlders = офуерлдерес
offworlder = офуерлдер
offworld = офуерлд
of = ов
ogalalla = огалала
ogura = огура
ohhhhh = оооооо
ohhh = ооо
oh = оу
oing = оінг
ojo = охо
o’kindlin = о-киндлін
okno = окно
okolo = около
ok = өкеј
oldtown = өлдтаун
olé = оле
ol = ол
o’me = о-мє
once = уѵнс
o’neill = о-нєл
one’s1 = уѵн-с
ones = уѵнес
one’s = уѵн-с
onflowing = онфлоуінг
oni = оні
onna = онна
onswud = онсуѵд
onto = онто
ontu = онто
on’t = ө-нт
oobeshimi = ообешімі
oobivat = убіват
ookadeeted = укадітед
ookadeet = укадіт
ookos = укоес
ooko = уко
oomny = умні
ooooh = ооооо
ooooooh = ооооооо
oopart = аѵпарт
oort = орт
oört = орт
oozhassny = ужасні
ooziness = узінесс
oo = оо
opaciter = опацітер
opafires = опафирес
opafire = опафир
operas = операес
opera = опера
ophiuchi = офіучі
oph = оф
ores = өрес
ore = өр
orff = орф
orgyporgy = оржіпоржі
orichalcum = орікалкѵм
ork = орк
orlandi’s = орланди-с
ornithopters = орніþоптерес
ornithopter’s = орніþоптер-с
ornithopter = орніþоптер
osho’s = ошо-с
osho = ошо
osooshing = осушінг
osoosh = осуш
ostiaries = остіаріес
otchkies = очкіес
othello’s = оþело-с
othello = оþело
otheym = оþејм
otho = оþө
o’trouble = о-трѵбл
oughtn’t = аѵт-нт
ought = аѵт
oulson = улсон
oure = аур
our’n = аур’н
ourouba = уруба
ours = аурес
ouster’s = аустер-с
outa = аута
outburst = аутберст
outcroppings = ауткропінгес
outcropping = ауткропінг
outcurve = ауткѵрв
outflex = аут¬флекс
outgoing = аутгоуінг
outlaws = аут¬лаѵес
outportal = аутпортал
outright = аутрајт
outta = аута
outthrust = аутþрѵст
outworlder = аутуерлдер
ovarin = оварін
overadaptation = өверадаптӕціон
overday = өвердеј
overeducated = өвер¬едұкӕтед
overfeint = өверфӕнт
overlaid = өверлејед
overlate = өверлӕт
overloud = өверлауд
overseer = өвер¬сєер
oversteppin = өверстепін
ovid = овід
ownerlike = оунер¬лик
ow’s = оу-с
owwwwwwme = оуууууумє
owwwwwwwww = оууууууууу
owwwwwwww = оуууууууу
owwwwww = оуууууу
owwwww = оууууу
owwww = оуууу
oxcarts = окскартес
o’you = о-ұ
o = о
p2 = п2
pacem’s = пацем-с
pacem’s = пацем-с
pacem = пацем
pacem = пацем
packbrids = пакбрідес
packbrid = пакбрід
padishahs = падішаес
padishah = падіша
padishah = падішах
padre = падре
pagesbyjoy = пӕжесбижоі
paid = пејед
pailed = пејлед
pailful = пејлфѵл
pailing = пејлінг
pails = пејлес
pail = пејл
pained = пејнед
paining = пејнінг
pains = пејнес
pain = пејн
paired = пӕред
pairing = пӕрінг
pairs = пӕрес
pair = пӕр
paks = пакес
palaceles = палацелес
palmaries = палмаріес
palmlock = палмлок
palms = палмес
palowhtiwa = палоутіуа
pandulph = пандулф
paneless = пӕнлесс
panglandular = пангландұлар
panna = пана
panoplia = панопліа
pantalonies = панталоніес
panurge = панѵрж
papa’d = папа’д
papapa = папапа
pappy = папі
paps = папс
paracompass = пӕракѵмпас
paradisal = парадисал
pardot = пардот
parvati = парваті
passerbys = пасер¬биес
passersby = пасерес¬би
passé = пасе
passin = пасін
pa’s = па‑с
pâté = пâтé
pâté = пате
patham = паþам
pathetically = паþетіклі
paths = паþес
path = паþ
pattypaws = паті¬паѵес
pausert’s = паѵзерт-с
pausert = паѵзерт
paus = паѵз
paus = паѵс
pau = паѵ
pau = поу
pavonis = павоніс
paw’s = пау-ес
payable = пејабл
paymasters = пеј¬мастерес
paymaster = пеј¬мастер
payment = пејмент
pchagavas = пчагавас
peacefully = піјцфѵллі
peaceful = піјцфѵл
peace = піјц
pealed = піјлед
pealing = піјлінг
peals = піјлес
peal = піјл
peas = піјес
peatlike = пєтлик
pea = піј
peebee = пєбіј
peepee = піјпіј
peeted = пєтед
peeting = пєтінг
pencilled = пенцілед
penfield = пенфєлд
penological = пеноложікал
pensatingly = пенсатінглі
pentashield = пенташєлд
pentstemmon’s = пентстемон‑с
pentstemmon = пентстемон
perakri = перакрі
percival’s = перцівал‑с
perecebo = перецебо
peritoneal = перітонеал
perlon = перлон
permabonded = пермабондед
perqs = перкес
personae = персөне
person’ll = персон‑л
persuaded = персуӕдед
persuades = персуӕдес
persuade = персуӕд
persuading = персуӕдінг
petersfield = пєтересфєлд
petey’s = пєті-с
petey = пєті
petronius = петрөніѵс
peyotl = пејотл
pfitzner = пфітцнер
pf = пф
phages = фӕжес
pharaoh = фӕрө
phd = фд
phoenix = фєнікс
phosphors = фосфорес
phosphortubes = фосфортұбес
photochemical = фөтокемікал
photographs = фөтографес
physico = фізіко
phzzt = фззт
ph = ф
piazza = піатца
pics = пікес
picuris = пікуріс
pierc’d = пєрц-д
pietà = піета
pigeons = піжонес
pigeon = піжон
pigtails = пігтејлес
pigtail = пігтејл
pigweeds = пігуєдес
pilgrimaging = пілгрімӕжінг
pinkham = пінкам
pirouetted = піру¬етед
pirouettes = піру¬етес
pirouette = піру¬ет
pirouetting = піру¬етінг
pishcha = пішча
pitchings = пічінгес
piter’s = питер-с
piter = питер
pizened = пизенед
placentin = плацентін
placher = плачер
plagued = плӕгед
plagues = плӕгес
plaguing = плӕгінг
plaiceed = плејцед
plaiceing = плејцінг
plaices = плејцес
plaice = плејц
plained = плејнед
plaining = плејнінг
plains = плејнес
plain = плејн
planetfall = планетфол
planetoids = планетоідес
planetological = планетоложікал
planetologist’s = планетоложіст-с
planetotogist = планетотожіст
planetwide = планетуид
plants’ll = плантес‑л
plasteel = пластєл
plasterbasin = пластербӕсін
plastician = пластіціан
platch = плач
platinum = платінѵм
platties = платіес
plautus = плаѵтѵс
players = плејерес
player = плејер
playfields = плеј¬фєлдес
playfield = плеј¬фєлд
playground = плеј¬граунд
playhouse = плејхаус
playin = плејін
playmates = плејмӕтес
playmate = плејмӕт
playrooms = плејрумес
playroom = плејрум
playthings = плеј¬þінгес
plaything = плеј¬þінг
playtime = плејтим
playwrights = плеј¬ритес
playwright = плеј¬рит
pleasin = плєзін
pleasures = плезұрес
plea = пліј
pleniscenta = пленісцента
plennies = пленіес
plenny = плені
plesk = плеск
pletchoes = плечоес
pletcho = плечо
pliers = плајерес
plier = плајер
ploshed = плошед
plotts = плоттес
plott = плотт
pluh = плѵ
plumbless = плѵмблесс
plushbottom = плѵш¬ботом
pneumatic = пнеѵматік
poached = пөчед
poaches = пөчес
poaching = пөчінг
poach = пөч
podooshka = подушка
podsnap’s = подснап-с
poges = пөжес
poggy = поггі
poinked = појнкед
pointillist’s = појнтіліст-с
pojoaque = пожоаке
polezny = полезні
polychrome = полі¬крөм
polyclefs = поліклефес
polyflex = поліфлекс
ponderosas = пондерөсас
pongi = понги
poogly = пуглі
pookong = пуконг
pools = пуулес
pool = пуул
pooooot = пуууут
poopoo = пупу
pooshkas = пушкаес
pooshka = пушка
poot = пуут
popdiscs = попдіскес
popdisc = попдіск
popé’s = попе-с
popé = попе
poppings = попінгес
poppling = поплінг
poppoppicorns = попопікорнес
popsong = попсонг
pores = пөрес
pore = пөр
porgy = поржі
poritrin = порітрін
porlumma = порлума
porthaven’s = порт¬хӕвен‑с
porthaven = порт¬хӕвен
porthole’s = портхөл-с
portraiture = портретұр
portwine = портуин
portyguls = портігулес
postfugue = пөстфұг
postgraduate = пөстградұӕт
postparty = пөстпарті
postscientific = пөстсциентіфік
poststroke = пөстстрөк
potentially = потенціаллі
poudre = пудр
poultices = пөлтіцес
poundcake = паундкӕк
powerfully = пауерфѵллі
pp = пп
praxiteles = праксітелес
prayerfully = прејфѵллі
prayers = прејерес
’preciate = ’прєціӕт
precogs = прекогес
precog = преког
precooking = прекукінг
predestinators = предестінӕторес
predestinator’s = предестінӕтор-с
predestinator = предестінӕтор
preemptory = прєемпторі
prejia = прєжіа
prejudiced = прежѵдіцед
prejudices = прежѵдіцес
prejudice = прежѵдіц
prejudicing = прежѵдіцінг
preliterate = прелітерат
prelude = прелұд
premote = премөт
preprogrammed = препрөграмед
prescience = пресціенц
prescient = пресціент
preseminary = пресемінарі
presses = прессес
presseth = пресеþ
pressure = пресұр
prestoopnicks = преступнікес
prestoopnick = преступнік
presymphony = пресімфоні
pre = пре
priapic = пріапік
priestley’s = прєстлі-с
prisms = прізмес
priss = пріс
prists = прістес
prists = прістес
privileged = прівілежед
privileges = прівілежес
privilege = прівілеж
privodeeted = пріводітед
proces = процес
profound = профаунд
prometheus = промеþеѵс
propheticus = профетікѵс
proprietorially = проприеторіаллі
prosecutin = просекұтін
prospero = просперө
protean = прөтеан
protectiva’s = протектіва-с
protectiva = протектіва
protein = протєін
provocated = провокӕтед
provocateurs = провокатұр
provok’st = провок-ст
prrrrrp = прррррп
prrrrzzzzrrrr = пррррззззрррр
pseudo = псеѵдө
psychiatrist = псикиатріст
psychoanalysis = псикөаналісіс
ps = пс
ptaaaaa = птааааа
ptitsas = птітсаес
ptitsa’s = птітса‑с
ptitsa = птітса
pt = пт
publicwise = пѵблікуиз
pueblos = пѵеблөес
pueblo = пѵеблө
puggily = пѵгілі
puggishly = пѵгішлі
punchipunching = пѵнчіпѵнчінг
punctually = пѵнктұаллі
pundi = пунді
punra = пунра
purée = пұре
purplewurple = пѵрплуурпл
purred = перед
purring = перінг
purrs = перес
purr = пер
purses = персес
purse = перс
pusscats = пускатес
pusspots = пуспотес
pussyfish = пусіфіш
put’em = пут’ем
puttenham = пѵтенхам
putting = путінг
puttin = путін
pyahnitsa = пјанітса
pyjamas = піжамаес
pyjama = піжама
pyons = пионес
pyreweed = пируєд
pyrobolts = пиробөлтес
pyrocket = пірокет
pyrophyllite = пирофілит
p = п
qanats = канатес
qanat = канат
qirtaiba = кіртајба
qizara = кізара
quartered = куортеред
quartering = куортерінг
quarte = куорте
quartos = куортоес
quatricentennial = куотріцентеніал
quayside = кєјсид
quay = кєј
quean = куіјн
queued = кеѵед
queues = кеѵес
queue = кеѵ
quickgold = куікгөлд
quizara = куізара
quran = куран
qwert = куерт
q = к
rabban’s = рабан-с
rabban = рабан
rabinovitch = рабіновіч
rachag = рачаг
rachmaninoff’s = ракманіноф-с
radars = радарес
radinski = радінскі
radleys = радліес
radosty = радості
ragged = рагед
railings’ve = рӕлінгес-в
rainin = рӕнін
rainstorm = рӕн¬сторм
raling = рӕлінг
ramadhan = рамадан
ramallo = рамало
ramscouts = рам¬скаутес
ramscout = рам¬скаут
ramship = рамшіп
ranchette = ранчет
rapido = рапідо
rapiers = рӕпірес
rapier = рӕпір
rapin = рӕпін
rarin = рӕрін
raskazz = расказ
rassoodocks = расудокес
rassoodock = расудок
rautha’s = рауþа-с
rautha = рауþа
rauxel = рауксел
rayish = рејіш
razdraz = раздраз
razrezzed = разрезед
razrez = разрез
razzes = разес
rd = рд
reachin = рєчін
read1 = рєд
read2 = ред
readers = ріјдерес
reader = ріјдер
reading = ріјдінг
readin = ріјдін
read’n’write = рєд-н-рит
reads = ріјдес
read = ріјд
realise = рєализ
realities = рєалітіес
reality = рєаліті
realization = рєалізӕціон
really = рєаллі
reals = рєалес
real = рєал
rebirths = реберþес
rebirth = реберþ
rebottling = реботлінг
rebreather = ребрєþер
recalibrate = рекалібрӕт
recalibration = рекалібрӕціон
recall1 = рєкол
recall2 = рекөл
recall = рекөл
recaths = рекаþес
rechi = речі
recolonization = реколонізӕціон
recolonize = реколониз
recopy = рекопі
recovery = ре¬кѵвері
recurrent = рекѵрент
redgold = редгөлд
redhot = редхот
redly = редлі
reeds = рєдес
reed = рєд
reentered = ре¬ентеред
reentering = ре¬ентерінг
reenters = ре¬ентерес
reenter = ре¬ентер
reentry = реентрі
refill1 = рєфіл
refill2 = рефіл
refugees = рефұжєес
refugee = рефұжє
regate = регӕт
regather = регаþер
regrown = регроун
reichs = рајкес
reigned = рӕјнед
reigning = рӕјнінг
reignition = реігніціон
reigns = рӕјнес
reign = рӕін
reins = рејнес
rein = рејн
reito = рејто
relayed = релејед
relaying = релејінг
relays = релејес
religion = реліжіон
religious = реліжіос
relled = релед
remarkin = ремаркін
rememberin = ремемберін
rememb’ring = ремембрінг
rendezvoused = рандевуед
rendezvoused = рандевузед
rendezvousing = рандевузінг
rendezvous = рандеву
renews = ренеѵес
rengeo = ренгео
reoccupied = реокұпіјед
repaid = репејед
repaired = репӕред
repairing = репӕрінг
repairs = репӕрес
repair = репӕр
repkit = репкіт
reproached = репрөчед
reproaches = репрөчес
reproaching = репрөчінг
reproach = репрөч
reprovisioned = репровізіонед
requi = рекуі
reread1 = рєрєд
reread2 = реред
reread3 = реред
rescued = рескұед
rescuers = рескұерес
rescuer = рескұер
rescues = рескұес
rescue = рескұ
rescuing = рескұінг
researched = рецерчед
researchers = рецерчерес
researcher = ресѵрчер
researcher = рецерчер
researches = рецерчес
researching = рецерчінг
research = рецерч
reservoired = резервуаред
resharpened = решарпенед
residential = резіденціал
resig = реси
respondu = респонду
restimulant = ре¬стімұлант
restolen = ре¬стөлен
restorante = ресторанте
resurrected = резѵректед
resurrecting = резѵректінг
resurrection = ре¬зѵрекціон
resurrects = резѵректес
resurrect = резѵрект
retarget = ретаргет
retellings = ретелінгес
retitled = ретитлед
returnest = ретѵрнест
reuben’s = реѵбен-с
reunions = реұніонес
reunion = реұніон
reunited = реұнитед
reunites = реұнитес
reunite = реұнит
reuniting = реұнитінг
reuther = ројþер
revitrifying = ревітріфиінг
revivification = ре¬вівіфікӕціон
revoltingness = ревөлтінгнесс
rewoven = реѵѵвен
reynolds’s = ренолдес-с
reynolds = ренолдес
reynold’s = ренолд‑с
reynold = ренолд
re = ре
rheumatism = реѵматізм
rheumy = реѵмі
rhombohedral = ромбохедрал
rhythms = ріþмес
ribcage = рібкӕж
richece = річеце
richese = річєз
richesse = річесс
rictus = ріктѵс
ridin = ридін
riffraff’s = ріфраф-с
righd = рајд
righted = рајтед
righteousness = рајтоснесс
righteous = рајтос
rightful = рајтфѵл
rightly = рајтлі
rightness = рајтнесс
rights = рајтес
rightways = рајтуејес
righty = рајті
right = рајт
rimbaud = рімбаѵд
ringringringing = рінгрінгрінгінг
ringy = рінгі
rithmet = ріþмет
rivendell = рівен¬дел
rk = рк
rmus = рмуес
rna = рна
roached = рөчед
roaches = рөчес
roaching = рөчінг
roach = рөч
roastbeef = рөстбєф
robe’d = рөб’д
rockin’ = рокін-
roly = рөлі
romaji = ромажі
romworks = ромуеркес
rookerfuls = рукерфѵлес
rookerful = рукерфѵл
rookers = рукерес
roosevelt = рөзевелт
roozlo = рузло
ropelike = рөп¬лик
ror = рор
rossak = росак
rotful = ротфѵл
’round = ’раунд
roustabout = раустабаут
royalship = ројалшіп
rozzer = розер
rozzes = розес
rozz = роз
rpgs = рпгес
r’s = рес
rt = рт
rubadubdub = рубадубдуб
ruefully = реѵфѵллі
rueful = реѵфѵл
rue = реѵ
ruft = рѵфт
rugi = руги
ruinin = рұінін
rural = рұрал
russky = рѵскі
rustlers = рѵслерес
rustler = рѵслер
rustlin = рѵслін
ruttin = рѵтін
r = р
sabiha = сабіа
sabogs = сабогес
sabog = сабог
sacheverell = сашеверел
sackful = сакфѵл
sacklike = саклик
sadus = садѵс
sadu = садұ
saggy = сагі
saguaro = сагуаро
sailed = сејлед
sailing = сејлінг
sailors = сејлерес
sailor = сејлер
sails = сејлес
sail = сејл
sainte = сент
sakar = сакар
sake2 = саке
salat = салат
salesman = сӕлес¬ман
salesmen = сӕлес¬мен
salesperson = сӕлес¬персон
salesrooms = сӕлес¬румес
salesroom = сӕлес¬рум
salmud = салмѵд
saltation = салтӕтіон
saltflats = солтфлатес
salusa = салуса
salvaged = салважед
sanada’s = санада-с
sanctorum = санкторум
sanc = санк
sans = сан
san’s = сан-с
saône = саон
sapho = сафо
sarai’s = сарај-с
sarai = сарај
sarcophogi = саркофожі
sardaukar’s = сардаукар-с
sardaukar = сардаукар
sarfa = сарфа
sarky = саркі
sarnath = сарнаþ
sarojini = сарожіні
sarum’s = сӕрѵм‑с
sashay = сашеј
sassed = сасед
satellit = сателіт
satori = саторі
sats = сатес
sats = сатес
saturdays = сатѵрдејес
saturday = сатѵрдеј
satyriasis = сатіріасіс
satyr’s = сатір-с
satyr = сатір
sayals = сејалес
sayal = сејал
sayest = сејест
sayeth = сајеþ
sayings = сејінгес
sayin = сејін
says = сез
says = сес
sayyadina’s = сајјадіна-с
sayyadina = сајјадіна
scarecrows = скӕр¬кроуес
scarecrow = скӕр¬кроу
scared’a = скӕред-а
scargrass = скар¬грас
scatted = скатед
scherzo = скертсө
schiller’s = шілер-с
schiller = шілер
schmidts = шмітес
schmidt = шміт
schmucks = шмѵкес
schmuck = шмѵк
schoenberg = шенберг
school’ll = скул‑л
school’s2 = скул-с
schrauder’s = шраудер-с
schrecklichkeit = шрек¬лік¬кајт
schrön = шрон
schubert’s = шуберт-с
schubert = шуберт
schuhplattler = шуплатлер
schultzes = шултцес
schultzie = шултці
schultz = шултц
schwartz’s = шуартц-с
schwartz = шуартц
schwarzgerät = швартцгерет
schweigselber = шуајгзелбер
sciences = сциенцес
scissored = сцізоред
scoteenas = скотінаес
scoteena = скотіна
scout’d = скаут’д
scout’n’me’ll = скаут-н-мє‑л
scout’n’me = скаут-н-мє
scoutships = скаут¬шіпес
scoutship = скаут¬шіп
screamin = скрємін
screechy = скрєчі
screwballs = скреѵ¬болес
screws = скреѵес
scrubtrees = скрѵб¬тріјес
scrubwoman = скрѵб¬ууман
scuppernongs = скѵпернонгес
scuppernongs = скѵпернонгс
scurried = скѵріед
scurries = скѵріес
scurrying = скѵріінг
scurry = скѵрі
scythelike = сциþлик
sdf = сдф
seagoing = сіј¬гоуінг
seagulls = сіјгѵлес
seagull = сіјгѵл
seamed = сіјмед
seaming = сіјмінг
seamstresses = сіјмстрессес
seamstress = сіјмстресс
seams = сіјмес
seam = сіјм
seaport = сіј¬порт
searched = церчед
searches = церчес
searching = церчінг
searchin = серчін
search = церч
seared = сіјред
searing = сіјрінг
sears = сіјрес
sear = сіјр
seashell = сіјшел
seaslug = сіј¬слѵг
seas = сіјес
seawalls = сіј¬уолес
seawall = сіј¬уол
seaweed = сіјуєд
seaworld = сіј¬уерлд
sea = сіј
seb’m = себ-м
seckatary = секатарі
secondmonth’s = секонд¬мѵнþ-с
secundus = секундус
sec’y = сек-і
sedmons = седмонес
seedships = сєд¬шіпес
seedship’s = сєд¬шіп-с
seedship = сєд¬шіп
seeing = сєінг
seein = сєін
seemfunnah = сємфѵна
sees = сєес
see = сє
selamlik’s = селамлік-с
selamlik = селамлік
selborne = селборн
selfie = селфі
semfa = семфа
semicircle = семі¬ціркл
semifeudal = семі¬феѵдал
seminarian’s = семінӕріан-с
semisentient = семі¬сенціент
semislaves = семіслӕвес
sempervirens = семпер¬віренс
semuta = семута
seneschai = сенешај
senesh = сенеш
senister = сеністер
sensuality = сенсұаліті
sensuously = сенсұослі
sensuousness = сенсұоснесс
sensuous = сенсұос
sepak = сепак
separateness = сепаратнесс
septem = септем
sepulcher = сепѵлкер
sepulveda = сепулведа
serrated = серӕтед
serrates = серӕтес
serrate = серӕт
serrating = серӕтінг
servok = сервок
servomotors = сервомөторес
servos = сервоес
sesquicentennial = сескуіцентеніал
sestina = сестіна
settin = сетін
settlin = сетлін
seventieth = севертіþ
several = северал
severn’s = северн-с
sewed = сөуед
sewing = сөуінг
sewin = сөуін
sewn = сөун
sew = сөу
sexlife = секслиф
sexophones = сексофөнес
sexophonists = сексофөністес
seyde = сед
seye = сеј
se = се
shaddam = шадам
shadout = шадаут
shadows = шадоуес
shadrach = шадрач
shaikas = шајкаес
shaika = шајка
shaitan’s = шајтан-с
shaitan = шајтан
shai = шај
shalish = шаліш
shal = шал
’shamed = ’шӕмед
shamin = шӕмін
shanghaied = шанг¬хајед
shan’t = ша-нт
shaowei = шаоуеј
shapechanger = шӕп¬чӕнжер
sharries = шаріес
shaw = шаѵ
shayla’d = шејла-д
shayla = шејла
sheared = шіјред
shearing = шіјрінг
shears = шіјрес
shear = шіјр
she’da = шє‑да
she’d = шє-д
sheepdog’s = шєп¬дог‑с
sheewash = шєуош
sheewa = шєуо
sheis = шєіс
shellburst = шелберст
shellburst = шелбѵрст
she’ll = шє-л
shest = шест
she’s = шє-с
shet = шет
she’ve = шє-в
shhhh = шшшш
shhh = шшш
shichi = шічі
shigawire = шігауир
shi’ites = шєитес
shiites = шєитес
shi’ite = шєит
shiite = шєит
shiker = шикер
shilarny = шіларні
shimmied = шіміед
shimoom = шімум
shininess = шинінесс
shinny = шіні
shipsecurity = шіп¬секұріті
shipsuit = шіп¬сұт
shiptime = шіп¬тим
shipwall = шіпуол
shipwork = шіп¬уерк
shirked = шеркед
shirking = шеркінг
shirks = шеркес
shirk = шерк
shirouzu = шіроузу
shirted = шертед
shirts = шертес
shirt = шерт
shishakli = шішаклі
shitara = шітара
shitehouse = шитхаус
shitpot = шіт¬пот
shiyah = шіја
shlaga = шлага
shlapa = шлапа
shlemmies = шлеміес
shlems = шлемес
shlem = шлем
shoab = шоаб
shoats = шөтес
shoat = шөт
shoeless = шу¬лесс
shoes = шуес
sholokov = шолоков
shoomny = шумні
shooms = шумес
shoom = шум
shootin’s = шутін‑с
shootin = шутін
shooty = шуті
shopfronts = шоп¬фрѵнтес
shote = шөт
shouko’s = шоуко-с
shouldn’a = шуд-н-а
shouldn’t = шуд-нт
should = шуд
shousou = шоусоу
shou = шоу
showin = шоуін
sho = шо
sho = шу
shree = шріј
shrikeproof = шрик¬пруф
shrike’s = шрик-с
shuttlecraft = шѵтл¬крафт
shyly = шајлі
shyness = шајнесс
sh = ш
sia = сіа
sich = січ
sicky = сікі
’sides = ’сидес
sidewalks = сидуаѵкес
sidewalk = сидуаѵк
’side = ’сид
sietch = сіеч
sifs = сіфес
sighted = сајтед
sightlessly = сајтлеслі
sight = сајт
sihaya = сіхаја
sikun = сікун
silenus’s = сіленѵс-с
silenus = сіленѵс
silhouettes = сілуетес
silhouette = сілует
silokwe = сілокуе
silu = сілу
silverflamed = сілверфлӕмед
simpatico = сімпатіко
simpler = сімплер
since = сінс
singery = сінжері
singleship = сінгл¬шіп
sinkchart = сінкчарт
sinkfield’s = сінкфєлд‑с
sinkfield = сінкфєлд
sinny = сіні
sinzer = сінзер
sioux = су
sira’s = сіра-с
sirat = сірат
sira = сіра
sirian = сіріан
siridar = сірідар
siri’s = сірі-с
sirius = сіріус
siri = сірі
sirra = сіра
sirs = серес
sir = сер
sisman = сісман
sissipriss = сісіпріс
sist = сіст
sittin = сітін
sixpence = сікс¬пенс
sixtieth = сікстіþ
sizy = сізі
skadelig = скаделіг
skazatted = сказатед
skazat = сказат
skiddaw = скідаѵ
skiddoo = скіду
skiers = скіерес
skier = скіер
skimmerport = скімер¬порт
skinsuit = скін¬сұт
skirmished = скермішед
skirmishes = скермішес
skirmishing = скермішінг
skirmish = скерміш
skirts = скертес
skirts = скертес
skirt = скерт
skirt = скерт
skitebird = скітебірд
skolliwoll = сколіуол
skorriness = скорінесс
skorry = скорі
skriking = скрікінг
skvatted = скватед
skvat = скват
skycab = скајкаб
skycover = скајкѵвер
skylight = скајлит
skylines = скајлинес
skyline = скајлин
skyscrapers = скај¬скрӕперес
skyscraper = скај¬скрӕпер
skyward = скајуорд
slabbily = слабілі
slaughterballs = слаѵтерболес
slaveholder = слӕв¬хөлдер
slavemaster = слӕвмастер
sleepglue = слєпглеѵ
sleepland = слєпланд
sleesh = слєш
slewed = слеѵед
slimefields = слим¬фєлдес
slipface = сліпфӕц
slipstrip = сліп¬стріп
slitherer = сліþерер
slitty = сліті
sloochatted = случатед
sloochatting = случатінг
sloochat = случат
slooshied = слушіед
slooshying = слушінг
slooshy = слуші
sloosh = слуш
sloptime = слоптим
slouse’s = слаус‑с
slouse = слаус
slovos = словоес
slovo = слово
slumyard = слѵм¬јард
slurped = слерпед
slurping = слерпінг
slurps = слерпес
slurp = слерп
slyly = слајлі
smacko = смакө
’smatter = ’сматер
’smatter = с-матер
smecked = смекед
smecking = смекінг
smecks = смекес
smeck = смек
smell’st = смел-ст
smockin = смокін
smokeholes = смөк¬хөлес
smotting = смотінг
smot = смот
snaggle = снагел
snakily = снакілі
snazzily = сназілі
sneery = снєрі
sneety = снєті
sneezy = снєзі
snoutie = снауті
snowflake = сноу¬флӕк
snugfitting = снѵгфітінг
snuggly = снѵглі
soaked = сөкед
soaking = сөкінг
soaks = сөкес
soak = сөк
soaped = сөпед
soapflakes = сөпфлӕкес
soaping = сөпінг
soaps = сөпес
soap = сөп
soba = соба
sobiratted = собіратед
sobirat = собірат
socrates’s = сократєс-с
socrates = сократєс
sojun = сожун
sokrates’s = сократес-с
sokrates’s = сократєс-с
sokrates = сократєс
solaris = соларіес
solari = соларі
solely = сөллі
solido = солідо
solipsistic = соліпсістік
solmev = солмев
solno = солно
sols = солес
sols = солес
sol’s = сол-с
sol = сол
someones = сѵмуѵнес
somewhere = сѵмуӕр
somme = сом
sondagi = сондаги
songster’s = сонгстер-с
sonietta = соніета
sons = сѵннес
son’s = сѵнн-с
son = сѵнн
sook = сук
soomka = сумка
soor = сур
sophistoes = софістөес
sophomore = софомор
sophy’d = сөфі’д
sorta = сорта
sos = сос
souci = суці
soundkey = саунд¬кіј
southwards = сауþ­уордес
souvenirs = сувенірес
sow’s = соу-с
sow = соу
so = сө
spacefarer = спӕ¬цфӕрер
spacefaring = спӕц¬фӕрінг
spacegoing = спӕц¬гоуінг
spacesickness = спӕц¬сікнесс
spagna = спаніа
spannungsbogen = спанунгсбоген
spasms = смазмес
spatchka = спачка
’specially = 
specially = спеціаллі
species = спєціес
species’ = спєціес-с
spedling’s = спедлінг-с
spedling = спедлінг
spermatazoa = сперматазоа
sperry = спері
spezzes = спезес
spheres = сфєрес
spiderweb = спидер¬уеб
spincomp = спін¬комп
spinmod’s = спін¬мод-с
spinships = спін¬шіпес
spinship = спін¬шіп
spiritous = спірітос
spitty = спіті
splatterific = сплатеріфік
splooge = сплуж
splussshhhh = сплѵшшшш
spongemeat = спѵнжміјт
spongesocks = спѵнж¬сокес
spongeturf = спѵнж¬терф
spoogy = спужі
sporification = споріфікӕціон
sporifies = споріфиес
sporify = споріфи
sporticopter = спортікоптер
s’pose = с-пөз
sprolly = спроллі
sproog = спруг
spuddy = спѵді
spung = спѵнг
spurned = спернед
spurning = спернінг
spurns = спернес
spurn = сперн
spurted = спертед
spurting = спертінг
spurts = спертес
spurt = сперт
spysats = спај¬сатес
sp = сп
squadmates = скуод¬мӕтес
squallin = скуолін
squares = скуӕрес
squawl = скуаѵл
squeakings = скуєкінгес
squeeeeeeeeeeak = скуєєєєєєєєєєк
squirmed = скуермед
squirming = скуермінг
squirms = скуермес
squirm = скуерм
squirted = скуертед
squirting = скуертінг
squirts = скуертес
squirt = скуерт
sr = ср
ss = сс
staban = стабан
stagefright = стӕж¬фрит
staggerin = стагерін
staircase = стејркӕс
stairs = стејрес
stairways = стејр¬уејес
stairway = стејр¬уеј
stairwells = стејруелес
stairwell = стејруел
stair = стејр
staja = стӕжа
stalks = стаѵкес
standably = стандаблі
starchiness = старчінесс
starfield = стар¬фєлд
stars = старес
starvation’ll = старвӕціон-л
starwise = стар¬уиз
stasis = стӕсіс
statefilm = стӕтфілм
statemarts = стӕтмартес
staticfilled = статік¬філед
statues = статұес
stdrd = стдрд
steak = стејк
stealing =стіјлінг
steals = стіјлес
stealthed = стелþед
steal =стіјл 
steersman’s = стєрсман-с
steersman = стєрсман
steersmen = стєрсмен
stenobenthic = стенобенþік
stenographers = стенограферес
stenographer = стенографер
stepdaddy = степ¬даді
stéphane = стефан
stephanie’d = стефані’д
steppes = степпес
steppe = степп
stereos = стереөес
stereotype = стереотип
stereo = стереө
sterile = стеріл
sterilized = стерілизед
sterilizes = стерілизес
sterilize = стерілиз
sterilizing = стерілизінг
stetho = стеþө
stevens’s = стєвен-с
stew’d = стеѵ-д
ste = сте
sticktite = стіктит
stilgar’s = стілгар-с
stilgar = стілгар
stimme = штіме
stimsims = стімсімес
stimsim = стімсім
stimstick = стімстік
stims = стімес
stim = стім
stinkin = стінкін
stirred = стеред
stirrings = стерінгес
stirring = стерінг
stirs = стерес
stir = стер
stoats = стөтес
stoat = стөт
stoneheap = стөн¬хєп
stoo = сту
storehouses = сторхаусес
storehouse = сторхаус
stormclouds = сторм¬клаудес
stormfront = сторм¬фрѵнт
storm’ll = сторм-л
stovewood = стөвууд
strangeness = стрӕнжнесс
strangia = странгіа
strangle’em = странгл-ем
strat = страт
stravidium = стравідіѵм
streetlamps = стрєт¬лампес
streetlights = стрєтлитес
streptocock = стрептокок
strongpoints = стронгпојнтес
studyin = стѵдіін
stuffin = стѵфін
stukatsky’s = стукатскі-с
stukatsky = стукатскі
stumphole = стѵмпхөл
stunner’s = стѵнер-с
’sturbed = ’стербед
sturdily = стѵрділі
sturdy = стѵрді
st = ст
subadolescent = сѵб¬адолесцент
subakh = субах
suberth = суберþ
subfief = сѵбфєф
subflexive = суб¬флексів
subiay’s = субіај-с
sublight = сѵб¬лит
subprofessional = сѵб¬професіонал
subspecked = сѵб¬спекед
subspeck = сѵб¬спек
subspected = сѵб¬спектед
substantiative = субстанціатів
subtemperature = сѵб¬темпратұр
subterranean = сѵбтерӕнеан
subvocalize = сѵбвөкализ
subwaizee = суб¬уејзі
suckin = сѵкін
sufrus = суфрѵс
sugar = шугар
sukares = сѵкарес
sukschool’s = сѵкскул-с
sukschool = сѵкскул
suliman’s = сѵліман-c
suliman = сѵліман
sumer = сумер
sunis = суніес
suni = суні
sunnan = сѵнан
sunnat = сунат
sunscorched = сѵнскорчед
suoh = суоу
superfluous = сұперфлѵос
superiors = сұпєріорес
supernaturally = сұпернатұраллі
supplement = сѵплмент
supplied = сѵплајед
suppliers = сѵплајерес
supplier = сѵплајер
supplies = сѵплајес
supplying = сѵплајінг
supply = сѵплај
surbringer = сѵрбрінгер
sureness = шұрнесс
sure’s = шұр-с
surety = шұрті
sure = шұр
surly = серлі
surrendered = сѵрендеред
surrendering = сѵрендерінг
surrenders = сѵрендерес
surrender = сѵрендер
surrogates = сѵрогатес
surrogate = сѵрогат
surrounded = сѵраундед
surroundings = сѵраундінгес
surrounding = сѵраундінг
surrounds = сѵраундес
surround = сѵраунд
surveyed = сѵрвејед
surveying = сѵрвејінг
surveyors = сѵрвејорес
surveyor = сѵрвејор
surveys = сѵрвејес
survey = сѵрвеј
sussurant = сусұрант
sussuration = сѵсұрӕтіон
sutherb = суþерб
suttons = сѵтонес
suu = суу
svoboda = свобода
swale = суӕл
swamplands = суомп¬ландес
swarmships = суорм¬шіпес
swarzschild = швартц¬шілд
swimstrips = суім¬стріпес
swingvines = суінг¬винес
swirled = суерлед
swirling = суерлінг
swirls = суерлес
swirl = суерл
swishhhh = суішшшш
swishings = суішінгес
swoony = сууні
swordpen = сордпен
sybils = сібілес
sykes’s = сикес‑с
symbolisms = сімболізмес
sympatico = сімпатіко
synapses = сінапсес
synapse = сінапс
synaptic = сінаптік
synergiser = сінержизер
synergizer = сінержизер
synthasilk = сінþасілк
synthemesc = сінþемеск
s’you = с-ју
syphilised = сіфілизед
syph = сіф
syrette = сірет
syubi = сјубі
’s = -с
s = с
taah = тааа
tabr = табр
tachyons = такіонес
tactual = тактұал
tafwid = тафуід
tahaddi = тахадді
tailed = тејлед
tailing = тејлінг
tailored = тејлеред
tailoring = тејлерінг
tailors = тејлерес
tailor = тејлер
tails = тејлес
tail = тејл
taishaku = тајшаку
take2 = таке
takemoto = такемото
takenao = такенао
takest = тӕкест
takin = тејкін
takraw = такраѵ
tákwa = та́куа
talkin = таѵкін
talks = таѵкес
tallness = толнесс
talsoe = талсо
tamon = тамон
tangee = танжіј
tangentially = танженціаллі
tangential = танженціал
tansley = танеслеј
taos = таос
taqwa = такуа
tarum = тарѵм
tas’ed = тас-ед
tashtooks = таштукес
tashtook = таштук
tastic = тастік
tavi = таві
tawrah = таѵра
tawra = таѵра
taxicopter = таксікоптер
taylors = тејлерес
taylor’s = тејлер-с
taylor = тејлер
tbd = тбд
tchab = чаб
tc = тк
teacakes = тіј¬кӕкес
teacake = тіј¬кӕк
teacherless = тєчер¬лесс
teachin = тєчін
teakettle = тіј¬кетл
teamed = тіјмед
teaming = тіјмінг
teams = тіјмес
team = тіјм
tear1 = тєр
tear2 = тӕр
teardrop = тєр¬дроп
tearing1 = тєрінг
tearing2 = тӕрінг
tears1 = тєрес
tears2 = тӕрес
tears = тєрес
tear = тєр
teaspoons = тіј¬спунес
teaspoon = тіј¬спун
teas = тіјес
tea’s = тіј-с
teatime = тіјтим
tea = тіј
technically = текніклі
techniques = текнікес
technocore’s = текно¬кор-с
technocore = текно¬кор
technocrats = текно¬кратес
technotoys = текно¬тојес
teeheeheeing = тєхєхєінг
teeps = тєпес
tegeuse = тежұз
teilhard’s = тејл¬хард-с
teilhard = тејл¬хард
telenews = теленеѵес
teleportation = телепортӕціон
telio = теліо
tellin = телін
temptations = темптӕціонес
temptation = темптӕціон
tem’s = тем-с
tem’s = тем-с
tenmonth = тен¬мѵнþ
tensaw = тенсаѵ
tensions = тенсіонес
’tention = ’тенціон
termex = термекс
terminex = термінекс
termi = термі
termi = термі
terraformed = тера¬формед
terraforming = тера¬формінг
terraform = тераформ
terrains = терӕнес
terrain = терӕн
terranic = теранік
terrence = теренц
terrestrial = терестріал
terrific = теріфік
terrorized = тероризед
terrorizes = тероризес
terrorize = терориз
terrorizing = тероризінг
terrors = терорес
terror = терор
teslas = теслаес
testifyin = тестіфиін
tesuque = тесуке
têta = тêта
tête = тêте
tetha’s = тєþа-с
tetha = тєþа
thalamic = þаламік
thalim = þалім
thambar = þамбар
tharsis = þарсіс
tharthar’s = þарþар-с
tharthar = þарþар
that’n = þат’н
that’s = þат-с
that’th = þат’þ
thatwise = þатуиз
tha = þа
thee = þє
theirs = þејрес
their = þејр
them’ll = þем-л
thence = þенс
theoretically = þєоретіклі
theoretical = þєоретікал
thereafter = þӕрафтер
there’d = þӕр-д
therefore = þӕрфор
there’ll = þӕр-л
theremogene = þєреможєн
thereof = þӕров
there’re = þер-р
there’s = þӕр-с
there’s = þер-с
there’ve = þер-в
therewith = þеруіþ
there = þӕр
thermcube = þерм¬кұб
thermite = þермит
thermouflage = þермофлаж
thermsuit = þерм¬сұт
theta’s = þєта-с
theta’s = þєта-с
theta = þєта
they’d = þеј-д
they’ll = þеј-л
they’re = þеј-р
they’s = þеј-с
they’ve = þеј-в
they = þеј
thing’ll = þінг‑л
things’ll = þінгес‑л
thirds = þердес
third = þерд
thirsty = þерсті
thirst = þерст
thirteenth = þертєнþ
thirteen = þертєн
thirties = þертіес
thirtieth = þертіþ
thirty = þерті
this’d = þіс-д
thiswise = þісуиз
thlosh = þлош
thomasmonth = томас¬мѵнþ
’thopters = þоптерес
thopter’s = þоптер-с
thopters = þоптерс
’thopter = þоптер
thopter = þоптер
thornblade = þорн¬блӕд
thornspikes = þорн¬спикес
thoroughfare = þѵроуфӕр
thoroughly = þѵроулі
thoroughness = þѵроунесс
thorough = þѵроу
thorsens = þорсенес
those’d = þөз-д
thoth = þоþ
thout = þаут
’thout = ’þоут
’thou = ’þоу
thp = тхп
thquirt = þкуерт
threbus = þрєбѵс
threescore = þрєскор
threes = þрєес
thrice = þрис
throats = þрөтес
throat = þрөт
throwin = þроуін
thrushbotham = þрѵш¬боþам
thr = þр
thufir’s = þуфір-с
thufir = þуфір
thuggees = þѵгєес
thuggee = þѵгє
thule = þѵле
thumbs = þѵмес
thumper’s = þѵмпер-с
thunderbottled = þѵндерботлед
thursdays = þѵрес­дејес
thursday = þѵрес­деј
thwok = þуок
thyroxin = þироксін
thy = þи
th = þ
ticklewickled = тіклуіклед
tida = тіда
tidepool = тид¬пуул
tied = тајед
tiers = тєрес
tiers = тіјрес
tier = тєр
tier = тіјр
ties = тајес
tie = тај
tightbeam = тит¬бєм
tikki = тікі
tillipwood = тіліпууд
timbuktu = тімбѵкту
timepieces = тимпєцес
timepiece = тимпєц
timesense = тимсенс
timey = тимі
timps = тімпес
tion = ціон
tiptoed = тіптөед
tiptoeing = тіптөінг
tiptoes = тіптөес
tiptoe = тіптө
tiredly = тиред¬лі
tiredness = тиреднесс
tissues = тісұес
’tis = т-іс
’tis = т-іс
tleielax = тлејелакс
tleilaxu = тлејлаксу
tleilax = тлејлакс
toadfrog = төдфрог
toads = төдес
toad = төд
tobi = тобі
tocker = токер
tocock = токок
today = тодеј
toenails = төнӕлес
toenail = төнӕл
toes = төес
toe = тө
together = тогеþер
tolchocked = толчокед
tolchocking = толчокінг
tolchocks = толчокес
tolchock = толчок
told’ja = төлд-жа
tollable = төлабл
toll’d = төл-д
tomakin = томакін
toma = тома
tombeau = томбоу
tombs = тумес
tomming = томінг
tomorrow’ll = томороу‑л
tongham = тонгхам
tongues = тѵнгес
toofles = туфлес
tootin = тутін
too = ту
top’s = топ-с
toptails = топтејлес
toquay = токуаі
torchships = торч¬шіпес
torchship = торч¬шіп
torii = торіі
toroid = торојд
toschahai = тошахаі
tos = тос
totally = төталлі
totin = төтін
to’t = то-т
touchous = тѵчос
toure = тоуре
tourism = турізм
tourists = турістес
tourist = туріст
tours = турес
tour = тур
to’ve = то-в
toward = тоуорд
towery = тауері
townsfolk = таунесфөк
townspeople = таунспєпл
townswomen = таунесуімен
townwards = таунуордес
tozzami = тотцамі
to = то
trabble = трабл
trada = трада
tramcars = трам¬карес
trank = транк
tranq = транк
transceiver = трансцєвер
translators = транзлӕторес
translator = транзлӕтор
transline’s = транс¬лин-с
transline = транс¬лин
transports’re = транс¬портес-р
transtemporal = транс¬темпорал
transweb = транс¬уеб
trapdoor = трапдор
trapezoidal = трапезојдал
trattoria = траторіа
trava = трава
treatin = трєтін
treehouse = тріјхаус
treeline = тріј¬лин
treesails = тріј¬сејлес
treesail = тріј¬сејл
treeships = тріј¬шіпес
treeship’s = тріј¬шіп-с
treeship = тріј¬шіп
trees’n = тріјес’н
trees = тріјес
treetops = тріј¬топес
treetop = тріј¬топ
tremblence = трембленц
tremoloing = тремолоуінг
trenchcoat = тренч¬көт
t’re = т-ре
trial’ll = триал‑л
trianon = тріанон
triaspen = триаспен
tribesman = трибсман
tribesmen = трибсмен
tribespeople = трибес¬пєпл
trichlormethyl = триклормеþіл
tricorne = три¬корн
trinocular = трінокұлар
trios = тріөес
trio = тріө
tripbeams = тріп¬бємес
trobriands = тробріандс
troches = трөкес
troche = трөке
troller’s = тролер-с
troubadours = трубадорес
truer = треѵер
true = треѵ
truin = трұін
truly = треѵлі
truncheons = трѵнчонес
truncheon = трѵнчон
truthfully = треѵþфѵллі
truthful = треѵþфѵл
truthsayer = треѵþсејер
truthsay = треѵþсеј
truth’s = треѵþ-с
truth = треѵþ
tryin = трајін
t’s2 = т-с
tsilu = тсілу
tsimpo = тсімпо
tsingtao = тсінгтао
tsithl = тсіþл
tsk = тск
tsquare = т-скуӕр
tsun = тсун
tsuruta’s = тсурута-с
tsuruya’s2 = тсуруја-с
tsuruya = тсуруја
tsuru = тсуру
’t’s = т-с
t’s = т-с
tucson = тусон
tuek’s = туек-с
tuek = туек
tuesdays = теѵесдејес
tuesday = теѵесдеј
tuggin = тѵгін
tuggin = тѵгін
tuk’s = тук-с
tuk’s = тук-с
tuk = тук
tullurian = тѵлұріан
tumtum = тѵмтѵм
tunneler = тѵнелер
tunneling = тѵнелінг
tuonobasin = туонобасін
tupali = тупалі
tupile = тупил
turbobuggies = тѵрбө¬бѵгіес
turbospeedster = тѵрбө¬спєдcтер
turds = тердес
turd = терд
turnitoe = турнітое
turok = турок
turrets = тѵретес
turret = тѵрет
turtleback = тѵртл¬бак
turvydom = тѵрвідом
tusslin = тѵслін
tutankhamten = тутанкамтен
tute = тұт
tvs = твес
tv = тв
twangings = туангінгес
’twas = туоз
twas = туоз
twentieth = туентіþ
twentyish = туентііш
’twere = т-уер
twice = твис
twirled = тверлед
twirling = тверлінг
twirls = тверлес
twirl = тверл
twitchy = туічі
twittwittwittering = туіттуіттуіттерінг
’twixt = туікст
twoscore = туу¬скор
twos = тууес
two’s = туу-с
two = туу
tycho = тико
tying = тајінг
tyndal’s = тіндал-с
tyn = тін
tyrena’s = тирена-с
tyrena = тирена
t = т
ucla’s = ұкла-с
ucla = ұкла
uff = ѵф
ui = ұі
ukair = укајр
uk = ұк
uldune = ѵлдұн
uliet = уліет
ultoptimate = ѵлтоптімӕт
ultramorphine = ѵлтра¬морфін
ultramorph = ѵлтра¬морф
umman = уман
umma = ума
ump = ѵмп
umw = ұму
unaged = ѵн¬ӕжед
unapt = ѵнапт
unatoned = ѵнатөнед
unbelting = ѵнбелтінг
unblinking = ѵнблінкінг
unbottled = ѵнботлед
unbranched = ѵнбранчед
unbreachable = унбрєчабл
unburdened = ѵнберденед
unceiled = ѵнцєлед
unclipped = ѵнкліпед
uncombed = ѵнкөмед
uncradled = ѵнкрӕдлед
uncrated = ѵнкрӕтед
uncremated = ѵнкрємӕтед
undercurrents = ѵндеркѵрентес
undercurrent = ѵндеркѵрент
undergoes = ѵндер¬гоуес
undergoing = ѵндер¬гоуінг
undergone = ѵндер¬гон
undergo = ѵндер¬гоу
undersea = ѵндер¬сіј
understerilized = ѵндерстерілизед
underveshches = ундервешчес
undrugged = ѵндрѵгед
unescorted = ѵнескортед
unexhausting = ѵнегзаѵстінг
unfairness = ѵнфејрнесс
unfair = ѵнфејр
unfiled = ѵнфилед
unfordly = унфордлі
unfunny = ѵнфѵні
unfurled = ѵнферлед
unhousebroken = ѵнхаусбрөкен
unhypnotised = ѵнхіпнотизед
universum = ұніверсѵм
uniweb = ұніуеб
unknowns = ѵн¬кноунес
unknown = ѵн¬кноун
unk = ѵнк
unlearning = ѵнлернінг
unmalicious = ѵнмаліціос
unmonitored = ѵнмоніторед
unmuddied = ѵнмѵдіед
unnerving = ѵннервінг
unner = ѵнер
unnosy = ѵн¬нөзі
unpetaling = ѵнпеталінг
unpunctual = ѵнпѵнктұал
unreadable = ѵнріјдабл
unreal = ѵнрєал
unrecombinant = ѵнрекомбінант
unrotted = ѵнротед
unrouged = ѵнружед
unscarred = ѵн¬скаред
unscarred = ѵнскаред
unschooled = ѵнскулед
unshockable = ѵн¬шокабл
unslept = ѵнслепт
unslurred = ѵнслѵред
unsynthesized = ѵнсінþесизед
uns = унс
untalented = ѵнталентед
untrue = ѵн¬треѵ
untrustable = ѵнтрѵстабел
unvicious = ѵнвіціос
unviolent = ѵнвиолент
unwindin = ѵнуиндін
unwinking = ѵнуінкінг
unwithered = ѵнуіþеред
un = ұн
upline = ѵплин
upon = ѵпон
uppercaste = ѵперкаст
uprais’d = ѵпрејз-д
upright = ѵп¬рајт
uprush = ѵпрѵш
upsetting = ѵпсетінг
upstairs = ѵпстејрес
upthrustings = ѵпþрѵстінгес
uptight = ѵптит
urchins = ерчінес
urchin = ерчін
urethra = ұрєтра
urinate = ұрінӕт
urine = ұрін
uroshnor = урошнор
us2 = ұс
usa = ұса
use1 = ұс
use2 = ұз
uses1 = ұсес
uses2 = ұзес
uses = ұзес
use = ұз
usul = усул
ut = ут
uv = ѵв
uw = ѵу
u = у
vacated = вакӕтед
vacates = вакӕтес
vacate = вакӕт
vacating = вакӕтінг
vacation = вакӕціон
vacay = вӕкеј
vacuum = вакұѵм
vained = вејнед
vaining = вејнінг
vains = вејнес
vain = вејн
vala’s = вала-с
valerias = валеріаес
valiance = валіанц
valkyries = валкіріес
values = валұес
vandeur = вандѵр
vareeting = варітінг
vareet = варіт
varota’s = варота-с
varota = варота
vatches = вачес
vatch = вач
vaudevillia = ваѵдевіліа
vaysay = вејсеј
vdt = вдт
vecks = векес
veck’s = век‑с
veck = век
vedge = веж
vega = вега
vegetables = вежетаблес
vegetable = вежетабл
vellocet = велоцет
velours = велурес
velour = велур
veneer’s = венєр‑с
ventura = вентұра
verdurous = вердұрос
verite = вєрит
very = вері
veshches = вешчес
veshch = вешч
vezzarn = ветцарн
’ve = -в
vibraty = вібраті
vibro = вибро
victrolas = віктролаес
viddied = відіед
viddying = відіінг
viddy = віді
videos = відеоес
video = відео
vids = видес
vid = вид
vier = фір
viewplate = веѵплӕт
viewscreens = веѵскрєнес
views = веѵес
viii = viii
vikken = вікен
villagers = вілажерес
villains = віленес
villain’s = вілен-с
villain = вілен
villefranche = віјфранш
vinci = вінчі
virtues = віртұес
virtuously = віртұослі
virtuous = віртұос
viscose = віскөз
visitin = візітін
vocab = вокаб
vohnbrook’s = вонбрук-с
voilà = вуала
volcanoes = волкӕнөес
volcano = волкӕнө
voloss = волос
voltaire’s = волтӕр-с
voltaire = волтӕр
volunteers = волѵнтєрес
vomity = вомиті
vomity = воміті
von2 = фон
vonning = вонінг
voo = ву
voyeurism = вуајерізм
voyeuristic = вуајерістік
voyeurs = вуајерес
voyeur = вуајер
vred = вред
vs = вс
vu = вұ
v = в
waaaaah = уаааааа
waarrrh = уаарррх
wachet = вахет
wac = уак
wadn’t = уад‑нт
waf = уаф
wagners = вагнерес
wagonload = уагонлөд
wahad = уахад
wahnt = уаант
waihusiwa = уаіхусіуа
wailed = уејлед
wailing = уејлінг
wails = уејлес
wail = уејл
wained = уејнед
waining = уејнінг
wains = уејнес
wain = уејн
waiping = уајпінг
waistcoats = уејсткөтес
waistcoat = уејсткөт
waisted = уејстед
waisting = уејстінг
waists = уејстес
waisty = уајсті
waist = уејст
waited = уӕтед
waiting = уӕтінг
waitin = уӕтін
waitin = уӕтін
waitin = уејтін
wait’ll = уӕт‑л
waits = уӕтес
wait = уӕт
waived = уејвед
waives = уејвес
waive = уејв
waiving = уејвінг
wakeshot = уӕкшот
wali = уалі
walkin = уаѵкін
walkin = уаѵкін
walks = уаѵкес
wallows = уолоуес
wambling = уамблінг
wanderjahr = вандерјар
wanna’s = уона-с
wansiehn = ванзєн
wansing = уансінг
wantest = уонтест
warriorfish = уоріорфіш
wars = уорес
washin = уошін
washin = уошін
wasn’t = уоз-нт
waspy = уаспі
was = уоз
watchpocket = уочпокет
waterhole = уотерхөл
waterpipes = уотерпипес
wath = уоþ
waylaid = уејлејед
’way = ’уеј
wazzums = уазумес
wa = уа
wc = ук
weakened = уіјкенед
weakening = уіјкенінг
weakens = уіјкенес
weaken = уіјкен
weaklings = уіјклінгес
weakling = уіјклінг
weaknesses = уіјкнессес
weakness = уіјкнесс
weak = уіјк
wealed = уіјлед
wealing = уіјлінг
weals = уіјлес
weal = уіјл
weaned = уіјнед
weaning = уіјнінг
weans = уіјнес
wean = уіјн
weared = уејред
wearing = уејрінг
wears = уејрес
wear = уејр
weaselish = уєзліш
weasely = уизлі
weatherborn = уеþерборн
weavers = уіјверес
weaver = уіјвер
web’s = уеб-с
web’s = уеб-с
webtrade = уебтрӕд
webward = уебуорд
webworlds = уебуерлдес
weddin = уедін
wednesdays = уенес¬дејес
wednesday = уенес¬деј
we’d’ve = ує-д-в
we’d = ує-д
weelll = уеелл
weighed = уејед
weighing = уејінг
weighs = уејес
weights = уејтес
weight = уејт
weigh = уеј
weimont = уејмонт
weintraubs = уајнтраубес
weintraub’s = уајнтрауб-с
weintraub = уајнтрауб
weirder = уєрдер
weirdest = уєрдест
weirding = уєрдінг
weirdly = уєрдлі
weird = уєрд
weirwood = уєрууд
welcomed = уел¬кѵмед
welcomes = уел¬кѵмес
welcome = уел¬кѵм
welcoming = уел¬кѵмінг
welfare = уелфӕр
weling = уелінг
wellll = уеллл
we’ll = ує-л
welsh = уелш
wel = уел
we’l = ує-л
wensicia = уенсіціа
weren’t = уер-нт
were = уер
we’re = ує-р
we’ve = ує-в
weye = уеј
whadduh = уода
whaddya = уодја
whad’re = уод-р
whap = уап
wharves = уорвес
whatchamacallit = уочамаколіт
whatcha = уотча
whathisname = уотхіснӕм
what’m = уот-м
what’re = уот-р
whatsit = уотсіт
what’s = уот-с
whattyacallit = уотјаколіт
what’ve = уот-в
wha = уа
wheald = уіјлд
wheatfields = уєтфєлдес
wheek = уєєк
wheelbarrows = уєл¬бароуес
wheelbarrow = уєл¬бароу
wheelchairs = уєлчӕрес
wheelchair = уєлчӕр
whence = уенс
whence = уенс
whenever = уен¬евер
whereas = уӕраз
whereby = уӕрбај
where’d = уӕр-д
wherein = уӕрін
where’ll = уӕр-л
where’re = уӕр-р
where’re = уӕр‑р
where’s = уӕр-с
wherever = уӕр¬евер
where’ve = уӕр-в
wherewith = уӕруіþ
where = уӕр
whew = уеѵ
whichness = уічнесс
’while = ’уил
whirled = уерлед
whirles = уерлес
whirling = уерілінг
whirlpool = уерлпуул
whirlwinds = уерлуіндес
whirlwind = уерлуінд
whirl = уерл
whirred = уерред
whirring = уеррінг
whirrs = уеррес
whirr = уерр
whir = уерр
whished = уішед
whishhhhh = уішшшшш
whish = уіш
whiskery = уіскері
whisssssshhhhhhhhh = уішшшшшшшшш
whiteshire’s = уитшир-с
whiteshire = уитшир
who’da = ху‑да
who’d’ve = ху-д-в
who’d = ху-д
wholeheartedly = хоулхартедлі
whole = хоул
who’ll = ху-л
whooshed = уушед
whooshing = уушінг
whoo = хуу
who’re = ху-р
whoring = хорінг
who’s = ху-с
who’s = ху-с
who’ve = ху-в
whuff = уѵф
whump = уѵмп
why’d = уај-д
why’m = уај-м
whyn’t = уај-нт
why’n = уај-н
why’re = уај-р
wh = у
wickedness = уікіеднесс
wicked = уікіед
wife’d = уиф’д
willesden = уилесден
williwaw = уіліуаѵ
willowgrass = уілоуграс
willowily = уілоуілі
wilsonsway = уілсонсуеј
wind1 = уінд
wind2 = уинд
windsong = уіндсонг
windwagons = уіндуагонес
windwagon’s = уіндуагон-с
windwagon = уіндуагон
wind = уінд
winefred’s = уинфред‑с
winona = уинона
wintenberry = уінтербері
wireheading = уирхедінг
wiseass = уизас
wisent = візент
wisk = уіск
witchcraft = уітч¬крафт
witches = уітчес
witch’s = уітч-с
witch = уітч
without = уіþ¬аут
withou = уіþау
witley = уітлеј
witness’ll = уітнесс‑л
witsy = уітсі
wittedness = уітеднесс
wof = уов
wogglies = уогліес
wolfgang = волфганг
womanchild’s = ууманчилд-с
womangrove = уумангрөв
woman’s = ууман-с
woman = ууман
womblike = уумлик
wombs = уумес
womb = уум
wonderboy = уѵндербој
wonderin = уѵндерін
won’t = уө-нт
wooden = ууден
woodsprites = уудспритес
woodworkers = уудуеркерук
woodworker = уудуеркер
wood = ууд
wool = уул
wordsworth = уердес¬уерþ
workin = уеркін
workshed = уерк¬шед
worldcasts = уерлдкастес
worldcast = уерлдкаст
worldsport = уерлдспорт
worldtree = уерлдтріј
worldweb’s = уерлдуеб-с
worldweb = уерлдуеб
worplesden = уорплесден
worried = уѵріед
worries = уѵріес
worrying = уѵріінг
worryin = уѵріін
worry = уѵрі
wouldn’t = уд-нт
would’ve = уд-в
would = уд
wpa = упа
wrestler = реслер
wr = ур
w’s = у-ес
wuf = уѵф
wuh = уѵ
wurlitzeriana = вурлітцеріана
wut = уѵт
www = ууу
wychford = уічфорд
w = у
xaverian = зӕвєріан
xenoarchaeology = ксеноаркеоложі
xenoarcheological = ксеноаркеоложікал
xenoarcheologist = ксеноаркеоложіст
x’s = хес
xtc = кстк
xvii = xvii
xxiii = xxiii
xxv = xxv
xyz = цчш
x = екс
x = кс
yaa = јаа
yachts = јаѵтес
yacht = јаѵт
yahma = јама
yahoodies = јахудіес
yahoos = јахуес
yahzick = јазік
yakha = јаха
yali = јалі
yankees = јанкіјес
yankee = јанкіј
yappy = јапі
yarbleless = јарбллесс
yarbles = јарблес
yarblockos = јарблокоес
yarthe = јарþ
yarth = јарþ
yasuhiro = јасухіро
yasutaka’s = јасутака-с
yasutaka = јасутака
yattered = јатеред
yattering = јатерінг
yauuuuuuuuw = јаѵѵѵѵѵѵѵѵѵ
yawm = јаѵм
yawny = јаѵні
yawp = јаѵп
yaws = јаѵес
yawwwww = јаѵѵѵѵѵ
yeah = јеа
yearny = јєрні
yeats’s = јєтес‑с
yea = јеј
yeb’m = јеб-м
yeckated = јекатед
yeckate = јекат
yeeeow = јєєоу
yeesh = јєш
yellowdog = јелоу¬дог
yessir = јессер
yessum = јесѵм
yeth = јеþ
yevshensky = јевшенскі
yew = јеѵ
yggdrasill = ігдрасіл
yid = јід
y’know = ј-кноу
y’ll = ј-л
yoh = јоо
yokan = јокан
yonder’s = јондер‑с
yorick = јорік
yoshiji = јошіжі
you’da = ұ‑да
you’d = ұ-д
—youed = мердеред
—youers = мердеререс
—youer = мердерер
—youing = мердерінг
you’ll = ұ-л
you’n’scout = ұ-н-скаут
you’re = ұ-р
yourself = јорселф
yourselves = јорселвес
yours = јорес
your = јор
—yous = мердерес
you’s = ұес
you’ve = ұ-в
—you = мердер
you = ұ
y’r = ј-р
y’s = ш-ес
yueh’s = јує-с
yueh = јує
yu’e = ју’е
yuiop = јуіоп
yukata = јуката
yuki = јукі
yumyumyum = јѵмјѵмјѵм
yutna = јутна
y = ј
zabur = забур
zammechat = замечат
zasnoot = заснут
zeebo’s = зєбо-с
zeebo = зєбо
zein = зејн
zensunnis = зенсуніес
zensunni = зенсуні
zeplen = зеплен
zheena = жєна
zhin = жін
zide = зіде
zippicamiknicks = зіпікамікнікес
zippyjamas = зіппіжамаес
zizhi = зізжі
zocho = зочо
zombyish = зомбііш
zoobies = зубіес
zooby = зубі
zophar = зофар
zori = зорі
zubrick = зубрік
zu = зу
zvonock = звонок
zvook = звук
z = з

# ZZZ ај аѵ ау ӕ еј еѵ є і інг іј ј ој оу ө þ ѵ ұ ’s ¬
