# ӓ ё ә ӛ ӡ ӥ ј ӧ ꚋ ӱ ү
aaa = ааа
ac = ек
addendum = адендәм
afl = афл
agandar = агандар
ain’t = еи’нт
air = еир
akechi = акечи
alien’s = ӓлиен’с
alien = ӓлиен
altogether = олтүгеӡер
amalite = амалӥт
amirite = амӥрӥт
ampules = ампулз
ampule = ампул
arc’s = арк’с
aren’t = ар’нт
armorers = арморерз
armorer = арморер
asahina = асахина
asshole = асхӧл
attn = атн
a = а
à = а
baen = баен
bai = баи
baudelaire = бодлер
bewhiskered = беүискерд
beyond = бејонд
bioscience = бӥосцӥенц
birlstone = бәрлстӧн
bishamon = бишамон
bit’s = бит’с
bocaj = бокаж
bod = бод
bollems = болемз
bollem = болем
booyah = буја
boro2 = боро
bouquets = букез
bouquet = буке
bow1 = боу
bow2 = бау
bow = бау
brigaders = бригӓдерз
brigader = бригӓдер
brontë = бронте
bryton = брӥтон
buh = бә
buying = баиинг
buys = баиз
buy = баи
b = б
c1 = ц1
café = кафе
cakewalk = кӓкүӛк
canopus = канопус
can’t = ка’нт
caram = карам
’cause = ’кӛз
cgi = кжи
chaladoor = чаладур
chameleon = камёлеон
chamomile = камомил
chilly = чилли
chocolates = чоколатс
chocolate = чоколат
ciao = чао
cio = кио
cliché = клише
clype = клӥп
c’mon = к’мон
coevolved = коеволвд
comms = комз
comparison = компарисон
concie = концие
continua = континӱа
coolum’s = кулум’с
copilot’s = кӧпилот’с
couldn’t = куд’нт
creepily = крёпили
c = ц
daal = даал
deactivation = деактивӓцьон
déjà = дежа
delish = делиш
del’s = дел’с
derehn = дерен
dere = дере
detectivology = детективоложи
d’être = д’етр
didn’t = дид’нт
dionysus = дӥонӥсус
disassembling = дисасемблинг
disminded = дисмӥндед
dismind = дисмӥнд
dna = дна
doesn’t = дәз’нт
dolkan = долкан
don’t = дӧ’нт
door’s2 = дор’з
doppelgänger = допелгенгер
dren = дрен
dr = др
d = д
ec = ек
edogawa = едогаүа
eeeep = иииип
eep = иип
eighth = еитꚋ
elasmosaurus = еласмозӛрус
eldel = елдел
enantiomers = енантиомерз
enantiomer = енантиомер
englobement = енглӧбмент
englobe = енглӧб
enspored = енспорд
enspore = енспор
erlk = әрлк
ese = ёз
espers = есперз
esper = еспер
etc = етс
ethy = еꚋи
euglena = југлёна
euthelassia = ӱтеласиа
excentric = ексцентрик
excuse1 = екскӱс
excuse2 = екскӱз
excuses1 = екскӱсез
excuses2 = екскӱзез
exudates = егзудӓтс
eyeballs = аиболз
eyeball = аибол
eyebrows = аибрауз
eyebrow = аибрау
eyes = аиз
eye = аи
e = е
faints = феинтс
faint = феинт
falsehood = фолсхуд
famicom = фамиком
fanderbags = фандербагз
fanderbag = фандербаг
fandies = фандиз
fiancée = фиансе
fiancé = фиансе
fic = фик
fide2 = фӥде
folklore = фоуклор
folktales = фоуктӓлз
folktale = фоуктӓл
folk = фоук
forty = фоурти
fourth = фоурꚋ
four = фоур
fujiwara = фужиүара
fukami = фуками
fukuyou = фукујоу
furigana = фуригана
futoshi = футоши
fuukoumeibi = фуукоумеиби
f = ф
garandool = гарандул
genroku = генроку
ghoulies = гулиз
gilars = гиларз
giveaway = гив­аүеи
glassite = гласӥт
go2 = го
gothie = гоꚋи
gps = жпс
g’s = г’с
guar = гуар
gwarrr = гүаррр
g = г
hailie = хеили
hakama = хакама
haori = хаори
haploids = хаплоидз
haruhi’s = харухи’с
haruhi = харухи
haru’s2 = хару’з
haru’s = хару’с
haru = хару
hasbol = хасбол
head’s2 = хед’з
heian = хеиан
hella = хела
herself = хәрселф
hers = хәрз
her = хәр
he’s = хё’з
hexaperson = хексаперсон
heyaaaaas = хејааааас
heya = хеја
heyo = хејо
hikawa = хикаүа
himbo = химбо
historied = хисторид
hmm = хмм
hmph = хмф
hohenstaufen = хоенштауфен
holo = холо
honno = хонно
hours = ауерз
hour = ауер
how’s = хау’з
humanoid = хӱманоид
humphed = хәмфт
humphing = хәмфинг
humph = хәмф
huuuh = хәәә
hyakunin = хјакунин
hyoutan = хјоутан
hyrier = хӥриер
h = х
ideals = ӥдёалз
ideal = ӥдёал
id = ӥд
ii = ii
iii = iii
illtraming = илтрӓминг
illyla = илӥла
indifferent = индиферент
intentions = интенцьонз
intention = интенцьон
io = ио
ir = әр
isbn = исбн
ishizaki = ишизаки
isn’t = из’нт
isshu = ишшу
it’s = ит’з
ittara = иттара
itta = итта
iu = иу
jingu = жингу
jiro = жиро
jiten = житен
joan2 = жоан
jus’ = жәс’
juvie = жуви
j = ж
kaba = каба
kaen = каен
kanezane = канезане
kaoru = каору
kara = кара
karres = карес
karuta = карута
katakana = катакана
kerris = керис
ketering = кётеринг
keyboard = кёборд
key = кё
kilometers = киломётерз
kimono = кимоно
kinjiro = кинжиро
kinshi = кинши
klatha = клаꚋа
kofun = кофун
koizumi = коизуми
koke = коке
koma = кома
koromo = коромо
ko = ко
kujo = кужо
kuni = куни
kuyoh = кујоу
kyami = кјами
kyam = кјам
kyon’s = кјон’с
kyon = кјон
k = к
labour = лӓбор
laissez = лесе
lead1 = лед
lead = лёд
leewit = лёүит
legged = легд
lelaundel = лелӛндел
lenoir = ленуар
lepti = лепти
live1 = лӥв
live2 = лив
lived = ливд
lives1 = лӥвз
lives2 = ливз
live = лив
’ll = ’л
l’s = л’с
luoyang = луојанг
luxury = ләксӱри
lyrae = лире
lyrd = ләрд
ly = ли
l = л
m2 = м2
m5 = м5
maaaybe = меееибё
ma’am = мам
madelwud = мӓделүуд
mairu = маиру
makemake = макемаке
manaret = манарет
mandellin = манделин
manicholo = маничоло
margoli = марголи
marshi = марши
mebeckey = мебеки
medieval = медиёвал
medoirian = медоириан
mêlée = меле
merega = мерега
merisco = мериско
miffel = мифел
miko = мико
minder’s2 = мӥндер’з
mischief = мисчиф
mischievous = мисчивос
moander = моандер
mochi = мочи
moe = мое
mozart’s = мотсарт’с
mozart = мотсарт
mo = мо
mrs = мрс
mr = мр
ms = мс
mt = мт
mwa = мүа
mysclub = мискләб
m = м
nagato = нагато
naive = наив
naïve = наив
naoko = наоко
nao = нао
narated = нарӓтед
narates = нарӓтс
narate = нарӓт
narations = нарӓцьонз
naration = нарӓцьон
narative = наратив
narrators = нарӓторз
narrator = нарӓтор
nda = нда
nections = некцьонз
neldo = нелдо
nembi = немби
nig = ниг
nikaido = никаидо
nikkeldepain = никелдепеин
nikkerliss = никерлис
nishiya = нишија
no2 = но
nomu = ному
notin = нотин
notobe = нотобе
nottobe = ноттобе
n’t = ’нт
nuris = нуриз
nuri = нури
nyan = нјан
ny = нј
n = н
obey = обеи
obi = оби
occam = окам
oda2 = ода
ogura = огура
ohhh = ооо
once = үәнс
one’s1 = үән’с
one’s = үән’з
oni = они
onswud = онсүуд
ontu = онтү
oobeshimi = ообешими
oopart = аәпарт
oort = орт
oph = оф
orichalcum = орикалкум
outa = оута
outta = аута
o = о
pagesbyjoy = пӓжезбӥжои
palaceles = палацелес
panurge = панәрж
patham = паꚋам
paths = паꚋс
path = паꚋ
pausert’s = пӛзерт’с
pausert = пӛзерт
petey’s = пёти’с
petey = пёти
ph = ф
pigeons = пижонз
pigeon = пижон
planetoids = планетоидз
porlumma = порлума
precogs = прекогз
precog = преког
precooking = прекукинг
premote = премӧт
proprietorially = пропрӥеториалли
putting = пүтинг
p = п
q = к
ragged = рагд
read2 = ред
reading = рёдинг
read = рёд
realization = рёализӓцьон
really = рёалли
real = рёал
recalibration = рекалибрӓцьон
recall1 = рёкол
recall2 = рекӧл
recall = рекӧл
rechi = речи
refill1 = рёфил
refill2 = рефил
reigned = рӓинд
reigning = рӓининг
reignition = реигницьон
reigns = рӓинз
reign = рӓин
reito = реито
relled = релд
rengeo = ренгео
reprovisioned = репровизьонд
reread1 = рёрёд
reread2 = рерёд
reread3 = реред
researcher = ресәрчер
retellings = ретелингз
rockin’ = рокин’
romaji = ромажи
roustabout = раустабаут
rpgs = рпгз
r = р
sake2 = саке
san’s = сан’с
sayeth = сајеꚋ
says = сез
school’s2 = ’з
schubert’s = шуберт’с
schubert = шуберт
schuhplattler = шуплатлер
schwarzgerät = швартсгерет
screechy = скрёчи
sedmons = седмонз
selfie = селфи
sepak = сепак
sew = соу
se = се
sheewash = шёүош
sheewa = шёүо
she’s = шё’з
shichi = шичи
shimmied = шимид
shirouzu = широузу
shitara = шитара
shouko’s = шоуко’с
shousou = шоусоу
shou = шоу
silhouette = силует
simpler = симплер
sirian = сириан
sirius = сириус
slitty = слити
snazzily = сназили
soba = соба
sojun = сожун
sos = сос
species = спёцьез
species’ = спёцьез’с
splatterific = сплатерифик
sporification = спорификӓцьон
sporifies = спорифӥз
sporify = спорифӥ
s’pose = с’пӧз
starvation’ll = старвӓцьон’л
stasis = стӓсис
stealthed = стелꚋт
st = ст
suberth = суберꚋ
substantiative = субстанцьатив
sunnat = сунат
suoh = суоу
sutherb = суӡерб
suu = суу
synapse = синапс
synergiser = синержӥзер
synergizer = синержӥзер
synthasilk = синꚋасилк
’s = ’с
s = с
taishaku = таишаку
take2 = таке
takemoto = такемото
takenao = такенао
takraw = такраү
talsoe = талсо
tamon = тамон
tangentially = танженцьалли
tangential = танженцьал
tbd = тбд
tchab = чаб
tea’s = тё’с
teleportation = телепортӓцьон
thambar = ꚋамбар
that’s = ӡат’з
their = ӡеир
there’s = ӡер’з
they’d = ӡеи’д
they’ll = ӡеи’л
they’re = ӡеи’р
they’ve = ӡеи’в
they = ӡеи
thirty = ꚋәрти
thoth = ꚋоꚋ
threbus = ꚋребус
thr = ꚋр
th = ꚋ
tillipwood = тилипүуд
timey = тӥми
tobi = тоби
today = түдеи
together = түгеӡер
together = түгеӡер
toma = тома
too = ту
torii = тории
toward = түүорд
tozzami = тотцами
to = тү
tranq = транк
tremblence = трембленс
t’s2 = т’з
tsun = тсун
tsuruta’s = тсурута’с
tsuruya’s2 = тсуруја’з
tsuruya = тсуруја
tsuru = тсуру
t’s = т’с
tullurian = тулӱриан
tumtum = тәмтәм
two’s = түу’с
two = түу
t = т
uldune = улдӱн
universum = ӱниверсум
unreal = әнрёал
untrustable = әнтрәстабел
upon = әпон
upsetting = әпсетинг
uptight = әптаит
use1 = ӱс
use2 = ӱз
uses1 = ӱсез
uses2 = ӱзез
uses = ӱзез
use = ӱз
uw = әү
u = у
vacay = вӓкӓ
vala’s = вала’с
vatches = вачез
vatch = вач
vaudevillia = вӛдевилиа
vezzarn = ветцарн
vocab = вокаб
von2 = фон
voyeurism = вүајеризм
voyeuristic = вуајеристик
v = в
wansing = үансинг
wasn’t = үоз’нт
wa = үа
weasely = үӥзли
weren’t = үәр’нт
were = үәр
whatchamacallit = үочамаколит
what’s = үот’з
wha = үа
where’s = үер’з
whew = үӱ
whoo = хуу
who’s = ху’з
wh = ү
wind1 = үинд
wind2 = үӥнд
wind = үинд
wintenberry = үинтербери
wisent = визент
without = үиӡаут
woman’s = үуман’с
woman = үуман
won’t = үӧ’нт
wooden = үуден
woodworkers = үудүәркерз
woodworker = үудүәркер
wood = үуд
wool = үул
wouldn’t = үд’нт
would’ve = үд’в
would = үд
wrestler = реслер
wut = үәт
www = үүү
wychford = үичфорд
w = ү
xenoarchaeology = ксеноаркеоложи
xenoarcheological = ксеноаркеоложикал
xenoarcheologist = ксеноаркеоложист
xyz = чшь
x = кс
yacht = јӛт
yarthe = јарꚋ
yarth = јарꚋ
yasuhiro = јасухиро
yasutaka’s = јасутака’с
yasutaka = јасутака
yeesh = јёш
yokan = јокан
yoshiji = јошижи
you’re = ју’р
yours = јорз
y’s = ш’с
yukata = јуката
yuki = јуки
y = и
zizhi = зижжи
zocho = зочо
zori = зори
z = з

