aaah = ааа
aah = аа
ablative2 = аблеітів # tending to be removed
ablative = аблатів # case
ablaze = аблеіз
abohalima = абохаліма
abracadabra = абракадабра
absaraka = абсарака
absently = абсентлі
absentmindedly = абсентмаіндед
absque = абскѵе
abstentions = абстеншонз
abstention = абстеншон
abstractedly = абстрактедлі
absurdities = абсърдітіз
absurdity = абсърдіті
abuse1 = абіус # сущ.
abuse2 = абіуз # гл.
abuse = абіуз # гл.
acampora = акампора
acceptez = аксэпте
accessibility = аксесібіліті
accommodated = акомодеітед
accommodates = акомодеітс
accommodate = акомодеіт
accommodating = акомодеітінг
accommodations = акомодеішонз
accommodation = акомодеішон
accommodative = акомодеітів
accreditation = акредітеішон
accrediting = акредітінг
achatz = ахатс
acidity = асідіті
acrimonious = акрімоѵніос
additives = адітівз
additive = адітів
adenoidal = аденоідал
adirondacks = адірондакс
adirondack = адірондак
adjani = аџані
adjectives = аџектівз
adjective = аџектів
admirable = адмірабел
admirably = адміраблі
admirals = адміралз
admiralty = адміралті
admiral = адмірал
admirations = адміреішонз
admiration = адміреішон
admissibility = адмісібіліті
admonishment = адмонішмонт
adorabelle = адоребел
adoration = адореішон
adorees = адориз
adoree = адори
adriance = адріанс
adusdur = адесдѵр
aerodyne’s = еродаін’с
aerodyne = еродаін
affirmations = афірмеішонз
affirmation = афірмеішон
affluential = афлѵеншал
affreuse = афрøз
afore = афор
again = аген
ages = еіџез
age = еіџ
aggregation = агрегеішон
agonies = агоніз
agonists = агоністс
agonist = агоніст
agonized = агонаізд
agonizes = агонаізез
agonize = агонаіз
agonizingly = агонаізінглі
agonizing = агонаізінг
agony = агоні
agora = агора
ago = агоѵ
agrigenetics = агріџенетікс
agronomists = агрономістс
agronomist = агрономіст
ainsworth = еінсѵорѳ
ain’t = еі’нт
airhole = ерхоѵл
airy = ері
air = ер
aisy = еізі
ajaj = аџаџ
ajami = еіџамі
ajangle = аџангел
ajinomoto = аџіномото
alatas = алатас
alexandre = александр
algorithms = алгоріѕемз
algorithm = алгоріѕем
alighted = алаітед
alighting = алаітінг
aliminion = алімініон
alivedness = алаівднес
alkalay = алкалаі
alkalis = алкаліс
allensworth = алензѵорѳ
alligators = алігеіторз
alligator = алігеітор
all’s = ол’з
almanacs = олманакс
almoner = олмонер
alors = алор
aloud = ала́ѵд
alphanumeric = алфаніумерік
also = олсоѵ
alternacare = олтърнакер
alternator = алтернеітор
altiplano = алтіплано
altogether = олтѵгеѕер
amanuensis = аманѵенсіс
amasai = амасі
amaze = амеіз
ambassadorial = амбасадоріал
ambassadorships = амбасадоршіпс
ambassadorship = амбасадоршіп
ambassadors = амбасадорз
ambassador = амбасадор
ambassadress = амбасадрес
ambiguous = амбігіѵос
ambling = амблінг
ambuscade = амбѵскеід
amdur = амдѵр
amicitia = амісітіа
amiram = амірам
amphitheaters = амфіѳіатерз
amphitheater = амфіѳіатер
amphitheatre = амфіѳіатер
anacker = анакер
anacomp = анакомп
anaconda = анаконда
anacortes = анакортес
anacostia = анакостіа
anaesthetic = анесѳетік
anarchists = анаркістс
anarchist = анаркіст
anarchy = анаркі
anaren = анарен
and = анд
angelfield’s = еінџел​филд’с
angelfields = еінџел​филдс
angelfield = еінџел​филд
angleworms = ангелвърмз
angularity = ангіѵларіті
anhalt = анхалт
animating = анімеітінг
ankled = анкелд
annihilated = анаіілеітед
annihilate = анаіілеіт
annihilating = анаіілеітінг
annihilation = анаіілеішон
annotated = анотеітед
annotates = анотеітс
annotate = анотеіт
annotating = анотеітінг
annotations = анотеішонз
annotation = анотеішон
anomie = аномі
antagonisms = антагоніземз
antagonism = антагонізем
antagonistic = антагоністік
antagonists = антагоністс
antagonist = антагоніст
antagonized = антагонаізд
antagonize = антагонаіз
antagonizing = антагонаізінг
anteriormost = антіріормоѵст
anteroom = антерум
anthropocentric = анѳропесентрік
anthropogenic = анѳропеџенік
anthropological = анѳрополоџікал
anthropologists = анѳрополоџістс
anthropologist = анѳрополоџіст
anthropology = анѳрополоџі
anthropomorphic = анѳропоморфік
anthropomorphism = анѳропоморфізем
antigones = антігонез
antigone = атігоне
antiquarian = антікѵеріан
antiquities = антікѵітіз
antiquity = антікѵіті
antolik = антолік
any = ені
an = ан
aphrodite’s = афродаіте’с
aphrodite = афродаіте
apostol = апостол
appy = апі
apropos = апропо
arakelian = аракеліан
arboreal = арбореал
archaeologists = аркеолоџістс
archaeologist = аркеолоџіст
archaeology = аркеолоџі
archaeopteryx = аркеоптерікс
archæopteryx = аркеоптерікс
archaic = аркеіік
archangels = аркеінџелз
archangel = аркеінџел
archeopteryx = аркеоптерікс
architects = аркітектс
architectural = аркітекчѵрал
architectures = аркітекчѵрз
architecture = аркітекчѵр
architect = аркітект
architraves = аркітреівз
architrave = аркітреів
aren’t = ар’нт
argonauts = аргонѡтс
argonaut = аргонѡт
aristocratic = арістократік
aristocrats = арістократс
aristocrat = арістократ
aristophanes = арестофанез
arkansas = аркенсѡ
armful = армфѵл
armonk = армонк
armoured = арморд
aronhalt = аронхалт
arrietty’s = аріеті’с
arrietty = аріеті
arri = арі
artefact = артефакт
arthropods = арѳроподз
arthropod = арѳропод
artless = артлес
ascenders = асендерз
ashameda = ашеімда
asmodeus = азмодеѵс
assembling = асемблінг
associes = асосіз
astrakhan = астракан
astronomers = астрономерз
astronomer = астрономер
astronomy = астрономі
asty = асті
as’ve = аз’в
asylumsick = асаілѵмсік
asylums = асаілѵмз
asymptomatic = еісімптоматік
athleticism = аѳлетісізем
atonic = атонік
attributable = атрібіѵтабел
attributed = атрібіѵтед
attributes = атрібіѵтс
attribute = атрібіѵт
attributing = атрібіѵтінг
atworth = атѵорѳ
auditing = ѡдітінг
auditorium = ѡдіторіѵм
audley’s = ѡдлі’с
audley = ѡдлі
auf = аѵф
augusta = ѡгъста
auntie = аанті
aunts = аантс
aunt = аант
aurelio = аѵреліо
aurelius = ѡриліѵс
aureole = ѡреол
auroral = ѡрорал
aurora = ѡрора
authentic = ѡѳентік
authored = ѡѳорд
authoring = ѡѳорінг
authoritarianism = ѡѳорітаріанізем
authoritarian = ѡѳорітеріан
authoritatively = ѡѳорітеітівлі
authoritative = ѡѳорітеітів
authorities = ѡѳорітіз
authority = ѡѳоріті
authorizations = ѡѳорізеішонз
authorization = ѡѳорізеішон
authorized = ѡѳораізд
authorizes = ѡѳораізез
authorize = ѡѳораіз
authorizing = ѡѳораізінг
authorship = ѡѳоршіп
autocratic = ѡтократік
autocrat = ѡтократ
automatically = ѡтоматікаллі
automatics = ѡтоматікс
automatic = ѡтоматік
automobiles = ѡтомобилз
automobile = ѡтомобил
automotive = ѡтомоѵтів
autonomous = ѡтономос
autonomy = ѡтономі
autumn = ѡтѵм
avast = аваст
ave2 = ав
averaging = авраџінг
averell = аверел
aviaries = еівіаріз
awa = аѵа
awfully = ѡфѵллі
aylesworth = еілзѵорѳ
aylsworth = еілсѵорѳ
aylworth = еілѵорѳ
azerbaijanis = азербаіџаніз
azerbaijani = азербаіџані
a = а
babangida = бабангіда
babbling = баблінг
babette = бабет
babiarz = бабіарз
babinski = бабінскі
baboon = бабун
babushkas = бабѵшказ
babushka = бабѵшка
bacchanalia = баканеіліа
bacchanal = баканал
bachailian = бекеіліан
bacharach = бакарак
bachelorhood = бачелорхѵд
backstreets = бакстритс
backwards = бак­ѵордз
backward = бак­ѵорд
badnesses = баднесез
bafflement = бафелмент
bafflingly = бафлінглі
balladur = баладѵр
balm = балм
balthrop = балѳроп
balustrades = балѵстреідз
balustrade = балѵстреід
balustrading = балѵстреідінг
banacci = баначі
banalities = баналітіз
banality = баналіті
banal = банал
bananas = бананаз
banana = банана
banasiak = банасіак
banaszak = банашак
bancorporation = банкорпореішон
bandaged = бандаџд
banditry = бандітрі
banerjee = банерџи
banesto = банесто
banisters = баністерз
bankowski = банковскі
bankruptcies = банкръптсіз
bankruptcy = банкръптсі
bankrupted = банкръптед
bankrupt = банкръпт
banoun = банун
banyaluca = баніалѵка
baptismal = баптізмал
barakat = баракат
barak = барак
barbanel = барбанел
barnacles = барнакелз
barnacle = барнакел
barnham = барнам
barnowski = барновскі
baroness = баронес
baronets = баронетс
baronet = баронет
barracks = баракс
barraclough = бараклаѵ
barracuda = баракуда
barrell = барел
barre = барі
barritt = баріт
bartol = бартол
bashkirtseff’s = башкіртсев’с
bashkirtseff = башкіртсев
bathtimes = баѳ​таімз
batogowski = батоговскі
baze = беіз
bbc = ббк
bearup = беръп
beatrice = біатріс
beaucoup = боку
beaus = бѡѵз
beautifully = біутіфѵллі
beaux = бѡѵз
beau = бѡѵ
bechtol = бектол
bedazzlement = бедазелмент
bedbug = бед­бъг
bedclothes = бедклоѵѕз
bedcovers = бедкъверз
bedcover = бед​къвер
bednarczyk = беднарчік
bedsocks = бедсокс
bedsock = бедсок
bedstead = бедстед
bedtimes = бедтаімз
beechnuts = бичнътс
been = бин
beeswax = биіз­ѵакс
bees = биіз
beetling = битлінг
bee = биі
befeed = бефид
beightol = беітол
belay = белеі
benackova = беначкова
benak = бенак
beneficiaries = бенефішаріз
benequity = бенекѵіті
berettas = беретас
besotted = бесотед
bespectacled = беспектакелд
bespectacle = беспектакел
bestler = бестлер
beyond = беіонд
bialkowski = біалковскі
bilirakis = біліракіс
birchall = бъркал
bismarck = бізмарк
bismark = бізмарк
bismuth = бізмѵѳ
bizarrely = безарлі
bizzom = бізом
blacking = блакінг
blankenbeckler = бланкенбеклер
blankness = бланкнес
blared = блерд
blares = блерз
blare = блер
blaring = блерінг
blaze = блеіз
bleakly = бликлі
blepharisma = блефарізма
bloodshot = блъд​шот
bobbed = бобд
bodhisattvas = бодісатвас
bogeys = боѵгі
boggy = богі
bohall = бохал
boilerplates = боілерплеітс
boilerplate = боілерплеіт
bonnyrigg = боніріг
bonomo = бономо
bootlaces = бутлеісез
borak = борак
borealis = бореаліс
borrell = борел
borup = боръп
bosworth = бозѵорѳ
boundaries = баѵндаріз
bournemouth = борнмѵѳ
bovary = боварі
bow1 = боѵ # лук, узел, бант, смычок, дуга, согнуть(ся)
bow2 = баѵ # нос корабля, поклониться
bowed1 = боѵд
bowed2 = баѵд
bowed = боѵд
bowing1 = боѵінг
bowing2 = баѵінг
bowing = боѵінг
bows1 = боѵз
bows2 = баѵз
bows = боѵз
bow = боѵ
brackeen = бракин
bramhall = брамхал
branchings = бранчінгз
brasenby = бреізенбі
brattaslava = братаслова
breadcrumbs = бред­кръмз
breakages = бреікаџез
breathlessness = бреѳлеснес
brickwork = бріквърк
brièveté = бріэвте
brignac = брініак
brilliants = бріліантс
brimful = брімфѵл
bristol = брістол
britain = брітан
brockbank = брокбанк
brontës = бронтез
brontë’s = бронте’с
brontë = бронте
broomstick’ll = брумстік’л
brusqueness = бръскнес
bubbling = бъблінг
buchalter = бѵхалтер
bucharest = букарест
buckboard = бъкборд
buddleia = бъдлиа
buffed = бъфт
buffeted = бъфетед
bulgingly = бълџінглі
bumbling = бъмблінг
bunowski = бѵновскі
burak = бѵрак
burials = беріалз
burial = беріал
buried = берід
burkhalter = бъркхалтер
burrowed = бъроѵд
burying = беріінг
bury = бері
bustled = бъселд
busyness = бізінес
butorac = біуторак
buttocks = бътокс
buttock = бъток
buttoning = бътонінг
buying = бъіінг
buys = бъіз
buy = бъі
byronic = баіронік
bysshe = біш
b = б
cabaniss = кабаніс
cachou = кашу
cadorette = кадорет
cadwalladr = кадѵоледер
cahalan = кахалан
cahall = кахал
cakestand = кеік​станд
calamity = каламіті
calf = каф
calligraphic = каліграфік
calm = калм
calvaries = калваріз
calves = кавз
cameronian = камероѵніан
canariensis = канаріенсіс
canaries = канаріз
cancun = канкѵн
candlewick = кандел​ѵік
cannot = каннот
canopies = канопіз
canopy = канопі
can’t = ка’нт
canvassed = канваст
canvassers = канвасерз
canvasses = канвасез
canvassing = канвасінг
canvass = канвас
canvas = канвас
capitols = капітолз
capitol = капітол
cap’n = кап’н
caracara = каракара
caraker = каракер
carapace = карапеіс
career = карір
cargonoff = каргоноф
caricatured = карікачѵрд
caricatures = карікачѵрз
caricature = карікачѵр
caricaturist = карікачѵріст
carmichael = кармаікел
carmody = кармоді
carpenter’d = карпентер’д
carrasquel = караскел
carrasquillo = караскіло
carrawell = караѵел
carreker = карекер
carrell = карел
carrey = карі
carrian = каріан
carrick = карік
carrie = карі
carrillo = каріло
carrington = карінгтон
carrion = каріон
carryforwards = каріфорѵордз
carryforward = каріфорѵорд
carryover = каріоѵвер
cartographer = картографер
cartographic = картографік
casad = касад
casdorph = касдорф
casilinum = касілінѵм
cassaday = касадеі
cassady = касаді
castile = кастил
castors = касторз
cataclysmic = катаклізмік
cataclysm = катаклізем
catacombs = катакоѵмз
catacomb = катакоѵм
catastrophic = катастрофік
categorization = категорізеішон
categorized = категораізд
categorizes = категораізез
categorize = категораіз
categorizing = категораізінг
catholic = каѳлік
catley = катлі
catullus = катѵлѵс
cauld = кѡлд
cauthorn = кѡѳорн
cawthorne = кѡѳорн
cawthorn = кѡѳорн
ça = са
ceilings = сиілінгз
ceiling = сиілінг
celestial = селесчал
cellular = селіѵлар
centenarians = сентенаріанз
centenarian = сентенаріан
centerpieces = сентерписез
centipedes = сентіпидз
centocor = сентокор
centrepin = сентерпін
cereals = сіреалз
cereal = сіреал
c’est = с’эт
chacabuco = чакабіуко
chaiken = чеікен
chaises = шеізез
chalker = чѡкер
chalk = чѡк
chambermaids = чамбермеідз
chambermaid = чамбермеід
chanced = чанст
chaos = кеіос
chaotic = кеіотік
chaperoned = шапероѵнд
chaperon = шапероѵн
chapped = чапт
characteristically = карактерістікаллі
characteristics = карактерістікс
characteristic = карактерістік
characterizations = карактерізеішонз
characterization = карактерізеішон
characterized = карактераізд
characterizes = карактераізез
characterize = карактераіз
characterizing = карактераізінг
characters = карактерз
character = керактер
charing = чарінг
charismatics = карізматікс
charismatic = карізматік
charisma = карізма
charlesworth = чарелсѵорѳ
charon = карон
chars = чарз
chatters = чатерз
cheerily = чірілі
cheneys = чеініз
cheques = чекс
cheque = чек
chestnuts = чеснътс
chestnut = чеснът
chez = ше
chicago = шікагоѵ
chichesters = чічестерз
chimbley = чімблі
chiming = чаімінг
chinaman = чаінаман
chine = шін
chins = чінз
chiropractors = каіропракторз
chiropractor = каіропрактор
chisenhall = чісенхал
chismar = чізмар
chivas = чивас
chloroplasts = клоропластс
chloroplast = клоропласт
chloroprene = клороприн
chocolate = чоклат
chodorow = ходоров
choir = кѵаір
chrismon = крізмон
chrissake = краіс­сеік
christenings = крісенінгз
christophel = крістофел
christopher = крістофер
chronometry = кронометрі
circumnavigated = съркѵмнавігеітед
circumnavigates = съркѵмнавігеітс
circumnavigate = съркѵмнавігеіт
circumnavigating = съркѵмнавігеітінг
circumnavigation = съркѵмнавігеішон
circumvention = съркѵмвеншон
clairmont = клермонт
claremont = клермонт
claret = кларет
clare = клер
clasping = класпінг
clasps = класпс
clatters = клатерз
claustrophobically = клѡстрофоѵбікаллі
clearness = клірнес
cleopatra = клиопатра
cleverer = клеверер
clime = клаім
clockwatching = клок​ѵочінг
clodia = клодіа
clods = клодз
clod = клод
close1 = клоѵс # прил.
close2 = клоѵз # гл.
close = клоѵс
clothespins = клоѵѕзпінз
clothespin = клоѵѕзпін
clove = клоѵв
coachhouse = коѵч​хаѵс
coagulate = коагіѵлеіт
coagulating = коагіѵлеітінг
coagulation = коагіѵлеішон
coarticulated = коартікіулеітед
coarticulates = коартікіулеітс
coarticulate = коартікіулеіт
coarticulating = коартікіулеітінг
coarticulation = коартікіулеішон
coathangers = коѵт­хангерз
coauthored = коѡѳорд
coauthoring = коѡѳорінг
coauthor = коѡѳор
coaxial = коаксіал
cobbles = кобелз
cochère = кошер
cockling = коклінг
cogitations = коџітеішонз
cognisant = когнізант
cogwheel = когѵил
coia = коіа
coincidences = коінсіденсез
coincidence = коінсіденс
coincidentally = коінсіденталлі
coincidental = коінсідентал
coincident = коінсідент
coincides = коінсаідз
coincide = коінсаід
coinsurance = коіншуранс
colicky = колікі
collingsworth = колінгзѵорѳ
collinsworth = колінсѵорѳ
colonels = кърнелз
colonel = кърнел
colorfully = кълорфѵллі
colourful = кълорфѵл
colourless = кълорлес
commentaries = коментаріз
commercialism = комършалізем
commercialization = комършалізеішон
commercialized = комършалаізд
commercialize = комършалаіз
commercializing = комършалаізінг
commitments = комітментс
commitment = комітмент
committeeman = комітиман
committee = коміти
commodities = комодітіз
commodity = комодіті
commodore = комодор
commoner = комонер
commonly = комонлі
companionable = компаніонабел
companionship = компаніоншіп
companionway = компаніонѵеі
complexity = комплексіті
comprehensibility = компрехенсібіліті
compuchem = компіукем
compulcated = компѵлкеітед
concussed = конкъст
confectionaries = конфекшонаріз
confidingly = конфаідінглі
confirmations = конфірмеішонз
confirmation = конфірмеішон
confusedly = конфіуздлі
connotational = конотеішонал
connotations = конотеішонз
connotation = конотеішон
consideringly = консідерінглі
consolingly = консоѵлінглі
constantinova = константінова
constipated = констіпеітед
constipates = констіпеітс
constipate = констіпеіт
constipation = констіпеішон
contemplative = контемплатів
contemporaneously = контемпореінеослі
contemporaneous = контемпореінеос
contemporaries = контемпераріз
contemporary = контемпорарі
contravention = контравеншон
contributed = контрібіѵтед
contributes = контрібіѵтс
contribute = контрібіѵт
contributing = контрібіѵтінг
contributors = контрібіѵторз
contributory = контрібіѵторі
contributor = контрібіѵтор
conversazione = конверсатсіоне
copetas = копетас
coracle = коракел
corduroy = кордѵроі
corked = коркт
corporacion = корпорасіон
corporal = корпорал
corporates = корпоратс
corporatewide = корпоратѵаід
corporate = корпорат
corporations = корпореішонз
corporation = корпореішон
corporatism = корпоратізем
corporatist = корпоратіст
corpora = корпора
correll = корел
correspondences = кореспонденсез
corrigible = коріџібел
cosmodrome = козмодроѵм
cosmonaut = козмонѡт
cotillion = котіліон
couldn’t = кѵд’нт
counterproposals = каѵнтерпропоѵзалз
counterproposal = каѵнтерпропоѵзал
courtesan = кортезан
covas = ковас
coverlet = къверлет
cowardice = каѵардіс
cowardly = каѵардлі
cowards = каѵардз
coward’s = каѵард’с
coward = каѵард
cowers = каѵерз
co = ко
cradled = креідел
crags = крагз
crampfurl’s = крампфърл’с
crampfurl = крампфърл
craning = креінінг
craze = креіз
creal = криал
creased = крист
creasing = крисінг
credentialed = креденчалд
creditable = кредітабел
creditably = кредітаблі
crediting = кредітінг
crêpe = креп
cressida = кресіда
crevices = кревісез
crinkled = крінкелд
crinkling = крінклінг
crinolines = крінолінз
crismon = крізмон
croaked = кроѵкт
crochet = кроѵше
crossly = крослі
crumbling = кръмблінг
crumpets = кръмпетс
crumpet = кръмпет
crumpling = кръмплінг
cryptography = кріптографі
cryptograph = кріптограф
cr = кр
cuisinart = кѵисінарт
cupboards = къпбордз
cupboard = къпборд
curiouser = кіѵріосер
curlicued = кърлікіѵд
currants = кърантс
currant = кърант
current = кърент
cursorily = кърсорілі
curtained = къртенд
curtains = къртенз
curtain = къртен
curvature = кървачѵр
custards = къстардз
cuyler = къілер
cwynar = кѵінар
cyclosporine = саіклоспорин
cyrillic = сірілік
czar = зар
c = к
dabbling = даблінг
dabs = дабз
dahlias = даліаз
daintily = деінтілі
damaged = дамаџд
dandurand = дандѵранд
dans = дан
daren’t = дер’нт
darning = дарнінг
darragh = дара
darryl = даріл
datacards = деітакардз
datacard = деітакард
datacomm = деітаком
datacomp = деітакомп
datacopy = деітакопі
d’autre = д’отр
dawdled = дѡделд
dazedly = деізедлі
daze = деіз
ddt = ддт
deadened = де́денд # омограф deadend
deafened = де́фенд # омограф defend
dears = дірз
deathday = деѳдеі
debartolos = дебартолоз
debora = дебора
decanters = декантерз
decanter = декантер
declamatory = декламаторі
declared = деклерд
declares = деклерз
declare = деклер
declaring = деклерінг
declension = декленшон
decomposed = декомпоѵзд
decomposes = декомпоѵзез
decompose = декомпоѵз
decomposing = декомпоѵзінг
decomposition = декомпозішон
decompression = декомпрешон
decorative = декоратів
deer = дир
defences = дефенсез
degraffenreid = деграфінреід
degregory = дегрегорі
deities = диетіз
deity = диеті
delaware = делаѵер
delettering = делетерінг
delightedly = делаітедлі
delineaments = делаінаментс
delineament = делаінамент
deltacorp = делтакорп
demarcated = демаркеітед
demarcate = демаркеіте
demont = демонт
denktas = денктас
denomme = деном
denouements = денумонз
dénouement = денумен
denouement = денумон
denseness = денснес
deodorants = деоѵдорантс
deodorant = деоѵдорант
deontological = деонтолоџікал
dermatological = дърматолоџікал
dermody = дърмоді
deschaine = дескеін
designate = дезігнеіт
designations = дезігнеішонз
designation = дезігнеішон
despairingly = десперінглі
detectives = детектівз
detective’s = детектів’с
detective = детектів
deteriorated = детіріореітед
deteriorates = детіріореітс
deteriorate = детіріореіт
deteriorating = детіріореітінг
deterioration = детіріореішон
detestable = детестабел
detests = детеcтс
detrimental = детріментал
detriment = детрімент
devastated = девастеітед
devastate = девастеіт
devastatingly = девастеітінглі
devastating = девастеітінг
devastation = девастеішон
deverell = деверел
devilment = девілмент
dewy = діуі
dew = діу
de = де
diabase = даіабеіс
diabasic = даіабеісік
diabetes = даіабитез
diabetics = даіабетікс
diabetic = даіабетік
diabolical = даіаболікал
diab = даіаб
diacritical = даіакрітікал
diacritic = даіакрітік
diadem = даіадем
diagnosed = даіагноѵст
diagnoses = даіагноѵсез
diagnose = даіагноѵс
diagnosing = даіагноѵсінг
diagnosis = даіагноѵсіс
diagnostek = даіагностек
diagnostics = даіагностікс
diagnostic = даіагностік
diagonally = даіагоналлі
diagonals = даіагоналз
diagonal = даіагонал
diagraming = даіаграмінг
diagrammatic = даіаграматік
diagrammed = даіаграмд
diagrams = даіаграмз
diagram = даіаграм
dialectical = даіалектікал
dialectic = даіалектік
dialects = даіалектс
dialect = даіалект
dialed = даіалд
dialing = даіалінг
dialogues = даіалогз
dialogue = даіалог
dialog = даіалог
dialtone = даіалтоѵн
diamagnetic = даіамагнетік
diamagnetism = даіамагнітізем
diamandis = даіамандіс
diamanta = даіаманта
diamante = даіаманте
diamant = даіамант
diametrically = даіаметрікаллі
diamono = даіамоно
diapers = даіаперз
diaphanous = даіафанос
diaphonia = даіафоѵніа
diaphragm = даіафрам
diarist = даіаріст
diasonics = даіасонікс
diasonic = даіасонік
diaspora = даіаспора
diastase = даіастеіс
diastole = даіастоле
diastolic = даіастолік
diathermy = даіаѳърмі
diatomic = даіатомік
diatoms = даіатомз
diatonic = даіатонік
diatribes = даіатраібз
diatribe = даіатраіб
dickory = дікорі
dictionaries = дікшонаріз
didja = дідџа
didn’t = дід’нт
digence = діџенс
dignitaries = дігнітаріз
dilapidation = ділапідеішон
dilettante = ділетанте
dilworth = ділѵорѳ
dimness = дімнес
dinars = даінарз
dinghies = дінгіз
dinotopia = даінотоѵпіа
disabling = дісеіблінг
disadvantaged = дісадвантаџд
disadvantages = дісадвантаџез
disadvantage = дісадвантаџ
disarms = дісармз
disarrangement = діс­а­реінџ­мент
disassembled: дісасембелд =
disassemble: дісасембел =
disciplinarians = дісіплінаріанз
disciplinarian = дісіплінаріан
discomforting = діскъмфортінг
discommoded = діскомоѵдед
discommode = діскомоѵд
disconcerted = дісконсъртед
disconsolately = дісконсолатлі
discouragement = діскъраџмент
discrediting = діскредітінг
disembodied = дісембодід
disentangled = дісентангелд
disharmony = дісхармоні
dishcloth = дішклоѳ
dishevelled = дішевелд
dishevelment = дішевелмент
disinter = дісінтър
disloyalty = діслоіалті
dismally = дізмаллі
dismal = дізмал
dismissively = дісмісівлі
disobeyed = дісобеід
disobeying = дісобеіінг
disparaged = діспараџд
disparagingly = діспараџінглі
disparaging = діспараџінг
disproportionately = діспропоршонатлі
disproportionate = діспропоршонат
disrespected = дісреспектед
disrespectful = дісреспектфѵл
disrespecting = дісреспектінг
disrespects = дісреспектс
disrespect = дісреспект
distantly = дістантлі
distributed = дістрібіѵтед
distributes = дістрібіѵтс
distribute = дістрібіѵт
distributing = дістрібіѵтінг
distributive = дістрібіѵтів
distributorships = дістрібіѵторшіпс
distributorship = дістрібіѵторшіп
distributors = дістрібіѵторз
distributor = дістрібіѵтор
disturbances = дістърбансез
disused = дісіуст
divined = діваінд
divinitas = дівінитас
dizzily = дізілі
doctorly = докторлі
documentaries = докіѵментаріз
dodecahedron = додекахидрон
dodgson = доџсон
dodsworth = додсѵорѳ
doesn’t = дъз’нт
doggish = догіш
don’t = до’нт
doorknobs = доркнобз
doorknob = доркноб
dorais = дореі
dorette = дорет
dornak = дорнак
dorrell = дорел
dotes = доѵтс
doubling = дъблінг
doubtfully = даѵтфѵллі
dousterswivel = даѵстерсѵівел
dragonair = драгонер
dragonhead = драгонхед
dragonheart = драгонхарт
dramas = драмаз
dramatical = драматікал
dramatists = драматістс
dramatist = драматіст
drama = драма
drat = драт
drawers = дрѡерз
drawer = дрѡер
dreamily = дримілі
dreamless = дримлес
dressmakes = дресмеікс
dribbet = дрібет
dribbling = дріблінг
drôle = дрол
drollery = дролері
droops = друпс
drownded = драѵндед
drowsily = драѵзілі
drowsing = драѵзінг
dr = доктор
dubarry = діубарі
dubiously = діубіослі
dulworth = дълѵорѳ
dumas = діѵма
dundore = дъндор
durability = діѵрабіліті
durakon = дѵракон
durango = дѵранго
durang = дѵранг
duran = дѵран
durette = дѵрет
during = діуринг
dusky = дъскі
dustless = дъстлес
dutifull = діѵтіфѵл
dvorak = дворак
dworak = дворак
d’ya = д’іа
d’ye = д’іи
d = д
eardrums = ір​дръмз
eared = ірд
earfull = ірфъл
earless = ірлес
earlobes = ірлоѵбз
earmarked = ірмаркт
earmarking = ірмаркінг
earmarks = ірмаркс
earmark = ірмарк
earmuffs = ірмъфс
earmuff = ірмъф
earphones = ірфоѵнз
earphone = рфоѵн
earpieces = ірпісез
earpiece = ірпіс
earplugs = ірплъгз
earplug = ірплъг
earrings = іррінгз
earring = іррінг
earshot = іршот
ears = ірз
earwax = ірѵакс
earwood = ір-ѵѵд
ear = ір
eavesdropped = ивздропт
ebanks = ебанкс
ebling = еблінг
ebook = ибѵк
echoed = екод
echoes = екоз
echograph = екограф
echohawk = екохѡк
echoing = екоінг
echoing = екоінг
echolocation = еколокеішон
econometrics = економетрікс
econometric = економетрік
economico = економіко
economies = економіз
economists = економістс
economist = економіст
economizes = економаізез
economize = економаіз
economizing = економаізінг
economy = економі
écru = екріу
ecstasy = екстасі
eddied = едід
eddying = едіінг
edgeworth = еџѵорѳ
editing = едітінг
editorialists = едіторіалістс
editorialist = едіторіаліст
editorialized = едіторіалаізд
editorialize = едіторіалаіз
editorializing = едіторіалаізінг
editorially = едіторіаллі
editorials = едіторіалз
editorial = едіторіал
editorship = едіторшіп
edwardian = едѵардіан
edward’s = едѵард’с
edward = едѵард
effigies = ефіџіз
effortful = ефортфѵл
eggletina’s = еглетіна’с
eggletina = еглетіна
egoism = игоізем
eiderdown = аідердаѵн
ejaculatory = еџакіѵлаторі
elaborately = елабореітлі
elaborate = елабореіт
elderflower = елдерфлаѵер
eldorado = елдорадо
eleanor = елеанор
electrophoretogram = електрофоретограм
electroplate = електроплеіт
electroplating = електроплеітінг
elephantiasis = еліфантаіасіс
elevenses = елевензез
eligaya = елігаіа
ellenbogens’ll = еленбогенз’л
ellenbogens = еленбогенз
ellenbogen = еленбоген
ellithorpe = еліѳорп
ellsworth = елзѵорѳ
eloped = елоѵпт
elucidation = елѵсідеішон
embarrassed = ембараст
embarrassingly = ембарасінглі
embarrassing = ембарасінг
embarrassments = ембарасментс
embarrassment = ембарасмент
embarrass = ембарас
embellishments = ембелішментс
embroiders = емброідерз
emirates = еміратс
emirate = емірат
’em’ll = ’ем’л
emotionally = емоѵшоналлі
enabling = енеіблінг
enamoured = енаморд
encomium = енкоѵміѵм
encouraged = енкъраџд
encouragement = енкъраџмент
encouragingly = енкаѵраџінглі
encouraging = енкъраџінг
endlessness = ендлеснес
endnote = енд​ноѵт
endurance = ендіуранс
engage = енгеіџ
england = інгланд
english = інгліш
engulfs = енгълфс
enquired = енкѵаірд
enquiries = енкѵаірз
enquiry = енкѵаірі
ensnared = енснард
ensnares = енснарз
ensnare = енснар
entropy = ентропі
enumerating = еніумереітінг
epistolary = епістоларі
epithets = епіѳетс
epithet = епіѳет
equipages = екѵіпаџез
equipage = екѵіпаџ
equitable = екѵітабел
equitas = екѵітас
equitation = екѵітеішон
equitec = екѵітек
equitex = екѵітекс
equities = екѵітіз
equity = екѵіті
ergonomically = ъргономікаллі
ergonomics = ъргономікс
ergonomic = ъргономік
erythropoietin = еріѳропоітін
eschatological = ескатолоџікал
esmé’s = есме’с
esmé = есме
esquisitos = ескѵізітос
esq = еск
essentials = есеншалз
essential = есеншал
estuaries = есчуаріз
e’s = е’з
etes = эт
êtes = эт
ethereal = еѳіреал
ethnomusicologist = еѳноміузіколоџіст
etiquette = етікет
ettie’d = еті’д
eucharist = іукаріст
europeans = іѵропианз
european = іуропеан
europewide = іѵропѵаід
europe = іуроп
evaporated = евапореітед
evaporates = евапореітс
evaporate = евапореіт
evaporating = евапореітінг
evaporation = евапореішон
evaporator = евапореітор
eventually = евенчѵаллі
every = еврі
examination = егзамінеішон
excitements = ексаітментс
excuse1 = екскіус # сущ.
excuse2 = екскіуз # гл.
excuse = екскіуз # гл.
exhalation = ексхалеішон
exhaling = ексхалінг
expectantly = експектантлі
experimentalist = експеріменталіст
experimentally = експеріменталлі
experimentation = експеріментеішон
experimented = експеріментед
experimenters = експеріментерз
experimenter = експеріментер
experimenting = експеріментінг
experiments = експеріментс
experiment = експерімент
extracurricular = екстракаракіѵлар
extraterritoriality = екстратеріторіаліті
extraterritorial = екстратеріторіал
eyebrows = ъібраѵз
eyebrow = ъібраѵ
eyeshadow = ъішадоѵ
eyes = ъіз
eye = ъі
e = е
fabius = фабіѵс
fabulist = фабіѵліст
facedly = феіседлі
fairbanks = фербанкс
fairbank = фербанк
faithfull = феіѳфѵл
falteringly = фолтерінглі
familiarity = фаміліаріті
familiarized = фаміліараізд
familiarize = фаміліараіз
fantasies = фантасіз
fantasizes = фантасаізез
fantasize = фантасаіз
fantasizing = фантасаізінг
fantasyland = фантасіланд
fantasy = фантасі
farnsworth = фарнсѵорѳ
farnworth = фарнѵорѳ
farrakhan = фаракан
farrell = фарел
farriers = фаріерз
farrier = фаріер
farrington = фарінгтон
farris = фаріс
fasnacht = фаснахт
fassnacht = фаснахт
fathomed = фаѕомд
faust’s = фаѵст’с
favourites = феіворітс
favourite = феіворіт
faze = феіз
fearfully = фірфѵллі
february’s = фебрѵарі’c
february = фебрѵарі
fedorchak = федорчак
fens = фенз
fergussen = фергѵсен
fêtes = феітс
fête = феіт
feverel = фиверел
fibres = фаіберз
fic = фік
fidgeted = фіџетед
fiduciares = фідѵсіарес
fiduciaries = фідіушаріз
figone = фігон
figurez = фігѵре
filigrees = філігриз
filigree = філігри
finanziaria = фінанзіаріа
finanziario = фінанзіаріо
finishedness = фініштнес
firelight = фаірлаіт
firesides = фаірсаідз
fireside = фаірсаід
firestaining = фаірстеінінг
fixedly = фікседлі
flared = флерд
flares = флерз
flare = флер
flaringly = флерінглі
flaring = флерінг
flatulent = флачѵлент
fledgling = фліџлінг
fleitas = флеітас
fleshless = флешлес
flicked = флікт
flimsiness = флімзінес
flinches = флінчез
flitted = флітед
flour = флаѵр
flowerbed = флаѵербед
flues = фліуз
fluidity = фліуідіті
fluted = фліутед
foie = фѵа
fois = фѵа
fondiaria = фондіаріа
foolishest = фулішест
foolscap = фулскап
footfalls = фѵтфолз
footstools = фѵтстулз
footstool = фѵтстул
foraged = фораџд
foraging = фораџінг
foraker = форакер
forelegs = форлегз
foreleg = форлег
forepaws = форпоѵз
forepaw = форпоѵ
foreshore = форшор
fore = фѡр
forgetfulness = форгетфѵлнес
forkfuls = форкфѵлз
forkful = форкфѵл
formedness = формеднес
fortas = фортас
fortnum = фортнѵм
fours = фоѵрз
fourth = фоѵрѳ
four = фоѵр
fowls = фоѵлз
fragonard = фрагонард
fraid = фреід
frailer = фреілер
franglais = франглэ
fraze = фреіз
fredonia = фредоніа
freize = фраіз
frenetically = френетікаллі
frias = фріаз
fribbling = фріблінг
fricatives = фрікатівз
fringed = фрінџд
frivolities = фріволітіз
froid = фроід
from = фром
frontispiece = фронтіспис
frustum = фръстѵм
fulfil = фѵлфіл
fumbling = фъмблінг
functionaries = фънкшонаріз
furiouser = фіѵріосер
furrows = фъроѵз
fyodorov = фіодоров
f = ф
gabbled = габелд
gabbling = габлінг
galerias = галеріаз
gallager = галагер
galleried = галерід
gambling = гамблінг
gametophyte = гамитофаіт
gaped = геіпт
garantizados = гаргантізадос
garrell = гарел
gaspy = гаспі
gastronomy = гастрономі
gatehouse = геітхаѵс
gauzy = гѡзі
gawthrop = гѡѳроп
gazetteer = газетір
gaze = геіз
genealogical = џенеалоџікал
genealogist = џенеалоџіст
genealogy = џенеалоџі
genemedicine = џинмедісін
genotypes = џенотаіпс
genotype = џенотаіп
geodesic = џеодесік
geoffroy = џефроі
geographically = џеографікаллі
geographical = џеографікал
geographic = џеографік
geological = џеолоџікал
geologic = џеолоџік
geometrically = џеометрікаллі
geometrical = џеометрікал
geometrics = џеометрікс
geometric = џеометрік
geomorphology = џеоморфолоџі
geordie = џорді
geotropic = џеотропік
geotropism = џеотропізем
germinates = џърмінеітс
giacometti = џакометі
giacomo = џакомо
gignac = жініак
gilligan = гіліган
gillihowlets = гіліхоѵлетс
giminy = џіміні
gimme = гім­ме
gipsy = џіпсі
gladdening = гладенінг
gladioli = гладіоѵлі
glared = глерд
glares = глерз
glare = глер
glaring = глерінг
glassless = гласлес
glaze = глеіз
glinted = глінтед
glowworm = глоѵ-ѵърм
gnawing = гнѡінг
gnaws = гнѡз
gnaw = гнѡ
gobbling = гоблінг
goggled = гогелд
golliwog = голіѵог
goracke = горак
goralski = горалскі
gorczyca = горчітса
gorczynski = горчінскі
gorecki = горетскі
gorgone = горгон
gorillas = горілаз
gorilla = горіла
gormbridge = гормбріџ
gorrell = горел
gossiping = госіпінг
governesses = гъвернесез
go = гоѵ
graduated = граџѵатед
graduates = граџѵатс
graduate = граџѵат
graduating = граџѵатінг
graduation = граџѵеішон
grammars = грамарз
granary = гранарі
grandchildren = гранчілдрен
granddad = гранддад
granddaughters = гранддѡтерз
granddaughter’s = гранддѡтер’с
granddaughter = гранддѡтер
grandma = грандма
grandness = гранднес
grandparents = грандпарентс
grandparent = грандпарент
grandpa = грандпа
gras = гра
grateau = грато
gratings = греітінгз
graveled = гравелд
gravelled = гравелд
gravitas = гравітас
gravitationally = гравітеішоналлі
graze = греіз
greatcoat = греіткоѵт
gregorich = грегорік
gregorie = грегорі
gregory = грегорі
greyed = греід
greyness = греінес
grigory = грігорі
grippe = гріп
growed = гроѵд
grubbiness = гръбінес
grumblings = гръмблінгз
grumbling = гръмблінг
grzybowski = гжібовскі
guarantee = гаранти
gurgled = гъргелд
g = г
habituated = хебічѵеіт
hackathorn = хакаѳорн
hadn’t = хад’нт
hagedorn = хагедорн
haggis = хагіз
hainsworth = хеінсѵорѳ
hairbrush = хербръш
haird = хеірд
hairpins = херпінз
hairpin = херпін
haldana = халдана
halevi = халеві
halifa = халифа
halima = халима
halliciforn = халісіфорн
hallo = халоѵ
hallucinated = халіусінеітед
hallucinates = халіусінеітс
hallucinate = халіусінеіт
hallucinating = халіусінеітінг
hallucinations = халіусінеішонз
hallucination = халіусінеішон
hallucinatory = халіусінаторі
hallucinogenic = халіусіноџенік
haluska = халъска
hanak = хонак
hankies = ханкіз
hannibalic = ханібалік
hanthorn = ханѳорн
happinesses = хапінесез
haps = хапс
harebells = хе́рбелз
harebell = хе́рбел
hares = хе́рз
hare = хе́р
harmonies = хармоніз
harmonie = хармоні
harmony = хармоні
harold = харолд
harold = харолд
harpsichords = харпсікордз
harrelson = харелсон
harried: = харід
harrier = харіер
harries = харіз
harriet = харіет
harrigan = харіган
harriman = харіман
harrington = харінгтон
harrison = харісон
harris = харіс
harrod’s = харод’с
harrod = харод
harrogate = харогат
harrop = хароп
harry = харі
harz = харц
hasn’t = хаз’нт
hassock = хасок
hathorne = хаѳорн
hauld = хѡлд
haunches = хаѵнчез
hauntings = хѡнтінгз
haven’t = хав’нт
haversack = хаверсак
hawaii = хаѵаіі
haworth = хаѵорѳ
haynesworth = хеінзѵорѳ
haynsworth = хеінзѵорѳ
haze = хеіз
hazily = хеізілі
heacham = хичам
headlamps = хедлампс
headscarf = хедскарф
heared = херед
hearing = хирінг
hearkened = харкенд
hearkening = харкенінг
hearkens = харкенз
hearken = харкен
hears = хирз
hearthrugs = харѳръгз
hearthrug = харѳръг
hear = хир
heathcliffe = хиѳкліф
heathcliff = хиѳкліф
heatwave = хитѵеів
heckathorn = хекаѳорн
hedgerows = хеџроѵз
hedgerow = хеџроѵ
he’d = хи’д
heedless = хидлес
hegemony = хеџемоні
heidorn = хаідорн
heirs = еірз
heir = еір # омофон к air=ер
helbling = хелблінг
helibroom = хелібрум
hellebore = хелебор
he’ll = хи’л
hemlocks = хемлокс
he’m = хи’м
hendrearys = хендреріз
hendreary’s = хендрері’с
hendreary = хендрері
hepworth = хепѵорѳ
hereditary = хередітарі
heredity = хередіті
here’s = хір’з
heretofore = хіртѵфор
here = хір
heroism = хероізем
herriage = херіаџ
herself = хърселф
hers = хърз
her = хър
hestered = хестерд
he’s = хи’з
heterosporous = хетероспорос
heureuse = øрøз
hexagonal = хексагонал
hickory = хікорі
hif = хиф
higgledy = хігелді
higher = хаіер
highwaymen = хаіѵеімен
hillocks = хилокс
himont = хімонт
hmm = хмм
hm = хм
hobbling = хоблінг
hochhalter = хокхалтер
hodds = ходз
hoddur = ходѵр
holes = хо́ѵлз
hole = хо́ѵл
holly = холі
holsworth = хоѵлсѵорѳ
holtrop = хоѵлтроп
holzworth = хоѵлзѵорѳ
homographs = хомографс
homograph = хомограф
homonym = хомонім
honaker = хонакер
hoptoad = хоптоѵд
horak = хорак
hornak = хорнак
horred = хоред
horridest = хорідест
hours = ъѵрз
hour’s = ъѵр’с
hour = ъѵр
housecoat = хаѵскоѵт
housemaids = хаѵсмеідз
housemaid = хаѵсмеід
howorth = хоѵорѳ
how’s = хаѵ’з
hoxworth = хоксѵорѳ
hrivnak = хрівнак
html = html
http = http
hucking = хъкінг
hughbanks = хъбанкс
humbling = хъмблінг
humidity = хіумідіті
humilité = ѵміліте
hummock = хъмлок
hurried = хърід
hurries = хъріз
hurrying = хъріінг
hurry = хърі
hurtfulness = хъртфѵлнес
hurtled = хъртелд
husbandry = хъзбандрі
husbands = хъзбандз
husband = хъзбанд
hyaluronic = хаіалѵронік
hydrangeas = хаідреінџеаз
hydrangea = хаідреінџеа
hydrochloric = хаідроклорік
hydrographic = хаідрографік
hydrophobia = хаідрофоѵбіа
hydroponic = хаідропонік
hygienic = хаіџинік
hymns = хімнз
hymn = хімн
hypnotism = хіпнотізем
hypnotists = хіпнотістс
hypnotist = хіпнотіст
hypnotized = хіпнотаізд
hypnotizes = хіпнотаізез
hypnotize = хіпнотаіз
h = х
i2 = i
iannaccone = іанаконе
iannacone = іанаконе
iar = іар
icitia = ісітіа
idaho = аідахоѵ
ideals = аідіалз
ideal = аідіал
ideas = аідіаз
idea = аідіа
identically = аідентікаллі
ideonomy = аідеономі
ides = ідес
i’d’ve = аі’д’в
i’d = аі’д
ignominious = ігномініос
ii = ii
iii = iii
illegibilities = ілеџібілітіз
illegibility = ілеџібіліті
illus = ілѵс
i’ll = аі’л
imaginings = імаџінінгз
immaturity = імачѵріті
immoderately = імодератлі
immoderate = імодерат
immunodeficiency = іміунодефішенсі
imperturbable = імпертърбабел
impetuously = імпечѵослі
improprieties = імпропраіетіз
impropriety = імпропраіеті
impulses = імпѵлсез
impulse = імпѵлс
i’m = аі’м
inaccessibility = інаксесібіліті
inaccessible = інаксесібел
inacomp = аінакомп
inacom = інаком
inattention = інатеншон
inaudibility = інѡдібіліті
incantations = інкантеішенз
incomer = інкъмер
incompletely = інкомплитлі
incompleteness = інкомплитнес
incorporated = інкорпореітед
incorporates = інкорпореітс
incorporate = інкорпореіт
incorporating = інкорпореітінг
incorporations = інкорпореішонз
incorporation = інкорпореішон
incorporeal = інкорпореал
incorrigible = інкаріџібел
incredulously = інкреџѵлослі
incrementalism = інкременталізем
indecipherable = індесаіферабел
indifferently = індіфрентлі
indigo = індіго
individualists = індівіџуелістс
individuals = індівіџѵалз
individual = індівіџѵал
indo = індо
indrawn = ін­дрѡн
indulgently = індълџентлі
inequitable = інекѵітабел
inequities = інекѵітіз
inequity = інекѵіті
inexpression = інекспрешон
inexpressivity = інекспресівіті
inheritors = інхеріторз
initialed = інішалд
initialing = інішалінг
initialized = інішалаізд
initialize = інішалаіз
initialling = інішалінг
inked = інкт
inmobiliaria = інмобіліаріа
innopac = інопак
inoffensiveness = інофенсівенес
inoffensiveness = інофенсівнес
inoffensive = інофенсів
insofar = інсоѵфар
instalments = інстолментс
instalment = інстолмент
instants = інстантс
instil = інстіл
instruments = інстрѵментс
instrument = інстрѵмент
inst = інст
insubstantial = інсѵбстанчал
insubstantiated = інсѵбстанчіеітед
insubstantiate = інсѵбстанчіеіт
intentions = інтеншонз
intention = інтеншон
interceptors = інтерсепторз
interceptor = інтерсептор
intercorporation = інтеркорпореішон
interim = інтерім
interlined = інтерлаінд
interlocutors = інтерлокіѵторз
interlocutor = інтерлокіѵтор
intermarriage = інтермаріаџ
intermediaries = інтермидіаріз
interposed = інтерпоѵзд
interrogatories = інтерогеторіз
interrogators = інтерогеіторз
interrogatory = інтерогеторі
interrogator = інтерогеітор
interventions = інтервеншонз
intervention = інтервеншон
intimating = інтіматінг
into = інтѵ
intracompany = інтракомпані
intracranial = інтракреініал
invigorated = інвігореітед
invigorate = інвігореіт
invigorating = інвігореітінг
invisibly = інвізіблі
involuntarily = інволѵнтарілі
inwards = інѵордз
irelan = ірелан
ironing = аіронінг
irons = аіронз
iron = аірон
irreproachable = ірепроѵчабел
irresponsibility = іреспонсібіліті
irritably = ірітаблі
isabelle’s = ізабел’с
isabelle = ізабел
isn’t = із’нт
isobel = ісобел
isocyanate = аісосаіенеіт
ist = іст
itineraries = аітінераріз
it’ll = іт’л
it’s = іт’з
i’ve = аі’в
iv = iv
ix = ix
jabaliya = џабаліа
jabbering = џаберінг
jabber = џабер
jacek = іатсек
jackanory = џаканорі
jacques = жак
jacquetta = џакета
jagiello = іагело
jagoda = іагода
jahner = іанер
jahns = іаанс
jaisigher = џеісігер
j’ai = ж’э
jamais = жамэ
jambes = жамб
janachowski = іанаховскі
janak = іанак
jarrell = џарел
jasinowski = іасіновскі
javanese = џавениз
javanese = џовениз
javascript = џаваскріпт
java = џава
java = џава
ja = џа
jean2 = жан
jelly = џелі
jenkinsop = џенкінсоп
jerkily = џъркілі
jerrell = џерел
jerusha’s = џеруша’с
jerusha = џеруша
jervie’s = џърві’с
jervie = џърві
jetsam = џетсам
jeweled = џуелд
jewelled = џуелд
jewellery = џуелрі
je = же
jingoism = џінгоізем
joanie’ll = џоѵні’л
joanie’s2 = џоѵні’з
joanie’s = џоѵні’с
joanie = џоѵні
jollity = џолліті
jolly = џолі
jottings = џотінгз
jotting = џотінг
juddering = џъдерінг
judith’s = џудіѳ’с
judith = џудіѳ
junior’ll = џуніор’л
justitiae = іѵстісіе
jutted = џътед
j = џ
kahalani = кохалоні
kaleidoscopic = калаідоскопік
kanak = канак
kanarek = канарек
kansas = канзас
karakos = каракос
karenalkalay = karenalkalay
karen = карен
kargonaov = каргонов
karraker = каракер
karry = карі
keening = кинінг
keratoconus = кератокоѵнѵс
ketcham = кечам
ketola = кетола
keyrings = ки-рінгз
keyring = ки-рінг
keys = киз
key = ки
kilbane = кілбан
kindliness = каіндлінес
kink = кінк
kiracofe = кіракоѵф
kismets = кізметс
kismet = кізмет
kittenish = кітеніш
kladstrup = кладстръп
klare = клер
kleptocrat = клептократ
klindworth = кліндѵорѳ
klintworth = клінтѵорѳ
kneels = книлз
kochanek = коханек
kochanowski = кохановскі
kochanski = коханскі
konop = коноп
koskotas = коскотас
krakowski = краковскі
kratochvil = кратоквіл
kraynak = креінак
kristol = крістол
kristopher = крістофер
krupinski = крѵпінскі
krush = кръш
kucharski = кѵхарскі
kujawa = куџаѵа
kundera = кѵндера
kvasnicka = кваснічка
labelling = леібелінг
laboratories = лабораторіз
laboratory = лабораторі
laboured = леіборд
labourers = леіборерз
labrake = лабрак
lacemaker = леісмеікер
lacksadaiscious = лаксадеісіос
lacunae = лакіуне
lakunin = лакѵнін
lamplight = ламп­лаіт
lancelet = ланслет
landefeld = ландефелд
landier = ландіер
landler’s = ландлер’с
landler = ландлер
languorous = лангѵорос
langworth = лангѵорѳ
l’appétit = л’апетіт
lare = лер
larijani = ларіџані
latecomers = леіткъмерз
latecomer = леіткъмер
lathrop = лаѳроп
laundress = лѡндрес
lava = лава
laxity = лаксіті
lazing = леізінг
ldd = лдд
leant = лент
lebanese = лебаниз
lebanon = лебанон
legalistic = легалістік
legionaries = лиџонаріз
lenart = ленарт
leonardo = леонардо
leonora = леонора
lesbianism = лезбіанізем
lesbia = лесбіа
lescaze = лескеіз
letchworth = лечѵорѳ
l’été = л’ете
letterbox = летербокс
levasseur = левасер
levelling = левелінг
levelly = левеллі
leveraged = ливераџд
leveraging = левраџінг
libraries = лаібраріз
libraries = лаібраріз
libreoffice = лібреофіс
lickerice = лікоріс
licquorice = лікоріс
liebling = либлінг
lifejackets = лаіфџакетс
lifejacket = лаіфџакет
lily’d = лілі’д
limply = лімплі
lindsays = лінзіз
lindsay = лінзі
lintas = лінтас
lipless = ліплес
lippett’s = ліпет’с
lippett = ліпет
liquidities = лікѵідітіз
liquidity = лікѵідіті
lisman = лізман
lissberg = лісберг
lissom = ліссъм
listlessly = лістлеслі
listless = лістлес
literature = літерачѵр
live1 = лаів # прил.
live2 = лів # гл.
lived = лівд # гл.
lives1 = лаівз # сущ.
lives2 = лівз # гл.
live = лів # гл.
livy = ліві
located = локеітед
locates = локеітс
locate = локеіт
locating = локеітінг
locations = локеішонз
location = локеішон
locksley = локслі
locomotion = локомоѵшон
locomotives = локомоѵтівз
locomotive = локомоѵтів
locomotor = локомоѵтор
loitered = лоітерд
loiters = лоітерз
lolled = лолд
lonelier = лоѵнліер
loneliest = лоѵнліест
longes = лонж
longues = лонгз
longue = лонг
loquaciously = лоѵкѵеішослі
loquacity = локѵасіті
lordsakes = лордсеікс
l’oreal = л’ореал
lorimar = лорімар
lothrop = лоѳроп
lounged = лаѵнџд
lovelier = лъвліер
loveliest = лъвліест
lowood = лоѵуд
loyalists = лоіалістс
loyalist = лоіаліст
loyall = лоіал
loyalties = лоіалтіз
loyalton = лоіалтін
loyalty = лоіалті
ltd = лтд
lubowski = лѵбовскі
lumbered = лъмберд
luminaries = ліумінаріз
luminosity = лѵміносіті
lumpen = лѵмпен
lupy = ліупі
lutwidge = лътѵіџ
luxuriating = лъкшѵріаітінг
luxuries = лъкшѵріз
luxury = лъкшѵрі
lyall = лаіал
lychgate = лічгеіт
lymphadenopathy = лімфаденопаѳі
lynott = лаінот
l = л
m2 = m2
m5 = m5
ma’am = ма’м
machacek = махачек
machamer = махамер
machismo = мачізмо
mackintoshes = макінтошез
macquarrie = маккарі
macsharry = макшарі
macula = макіѵла
madwoman = мад-ѵѵман
maeterlinck = метерлінк
magick = маџікк
mahalah = махала
mahala = махала
mahal = махал
malevolence = малеволенс
malignity = малігніті
malloseismic = молосаізмік
manageability = манаџабіліті
manageable = манаџабел
manak = манак
mangeant = манжан
mangerish = мангеріш
manjaca = маніача
mannarino = манаріно
mantelpiece = мантелпис
many = мені
maquiladora = макіладора
maracle = маракел
marak = марак
marechal = марешал
margaritas = маргарітас
marie = мари
marionettes = маріонетс
marnie’d = марні’д
marnie’s = марні’с
marnie = марні
marrakech = маракеш
marram = марам
marriageable = маріаџабел
marriage = маріаџ
married = марід
marries = маріз
marrying = маріінг
marry = марі
marshalling = маршалінг
martialed = маршалд
marvelling = марвелінг
marvellous = марвелос
massachusetts = масачучетс
massad = масад
ma’s = ма’с
matchsticks = мачстікс
maths = маѳс
matrimonial = матрімоѵніал
matrimony = матрімоѵні
matted = матед
mattocks = матокс
maudsley = мѡдслі
maximus = максімѵс
maybe = меіби
mazankowski = мазанковскі
maze = меіз
ma = ма
mcadory = макадорі
mcbrides = макбраідз
mcb = мкб
mccalmont = маккалмонт
mcclintock = макклінток
mcelligott = макелігот
mcgreal = макгриал
mcgregory = мегрегорі
mchale = маккеіл
mckinney = маккіні
mcmichael = макмаікел
mcnary = макнарі
mealtimes = милтаімз
meanderings = меандерінгз
mebane = мебан
mechanisms = меканіземз
mechanism = меканізем
mechanistic = меканістік
mechanization = меканізеішон
mechanized = меканаізд
mechanize = меканаіз
meddled = меделд
medicines = медісінз
medicine = медісін
meditate = медітеіт
meditating = медітеітінг
meditation = медітеішон
meditative = медітеітів
mediterranean = медітереінеан
mei’s = меі’с
menaker = менакер
menopausal = менопаѵзал
menopause = менопаѵз
menotomy = менотомі
mercenaries = мърсенаріз
meringues = марангз
meringue = маранг
meself = миселф
mesozoic = мезозоѵік
messamore = месамор
messmore = месмор
mes = мез
metacarpals = метакарпалз
metacarpal = метакарпал
metalsmith = металсміѳ
metastasized = метастасаізд
metastasize = метастасаіз
metonomy = метономі
metronomic = метрономік
metropolitain = метрополітан
metropolitans = метрополітанз
metropolitan = метрополітан
metropol = метропоѵл
mewling = міулінг
mewl = міул
m’gun = м’гън
miaowed = міаѵд
miaow = міаѵ
micanopy = міканопі
michaela = мікела
michaelina = маікеліна
michaeline = маікелаін
michaelis = маікеліс
michaella = маікела
michaelsen = маікелсен
michaelson = маікелсон
michaels = маікелз
michael = маікел
michalik = міхалік
microbiologists = маікробіолоџістс
microbiologist = маікробіолоџіст
microbiology = маікробаіолоџі
microbreweries = маікробріуеріз
microbrewery = маікробріуері
microcentrifuge = маікросентріфіуџ
microchips = маікрочіпс
microchip = маікрочіп
microcircuits = маікросъркітс
microcircuit = маікросъркіт
microclimates = маікроклаіматс
microclimate = маікроклаімат
microcodes = маікрокоѵдз
microcode = маікрокоѵд
microcomputers = маікрокемпіутерз
microcomputer = маікрокемпіутер
microcom = маікроком
microcredit = маікрокредіт
microdyne = маікродаін
microeconomics = маікроекономікс
microeconomic = маікроекономік
microelectronics = маікроелектронікс
microelectronic = маікроелектронік
microelettronica = маікроелетроніка
microfiche = маікрофиш
microfossils = маікрофосілз
microfossil = маікрофосіл
microgenesys = маікроџенесіс
micrograms = маікрограмз
microgram = маікрограм
micrographics = маікрографікс
micrographic = маікрографік
microliters = маікролітерз
microliter = маікролітер
micromanaged = маікроманаџд
micromanagement = маікроманаџмент
micromanages = маікроманаџез
micromanage = маікроманаџ
micromanaging = маікроманаџінг
micronesia = маікронижа
microorganisms = маікроорганіземз
microorganism = маікроорганізем
micropaleontology = маікропеілеонтолоџі
microphones = маікрофоѵнз
microprocessors = маікропросесорз
microprocessor = маікропросесор
microprose = маікропроѵз
micropro = маікропро
microsemi = маікросемі
microsoft = маікрософт
microsystems = маікросістемз
microtel = маікротел
microtubules = маікротіубіулз
microtubule = маікротіубіул
microvax = маікровакс
microware = маікроѵер
microwavable = маікроѵеівабел
microwaved = маікроѵеівд
microwaves = маікроѵеівз
middlemarch = міделмарч
middles = міделз
mightn’t = маіт’нт
mihalek = міхалек
mihalik = міхалік
mihaly = міхалі
militaries = мілітаріз
milligrams = міліграмз
milligram = міліграм
millinery = мілінері
milpitas = мілпітас
mimed = маімд
minarets = мінаретс
minaret = мінарет
minarik = мінарік
minott = мінот
miracles = міракелз
miracle = міракел
miraculously = міракіѵлослі
miraculous = міракіѵлос
mirad = мірад
mirages = міражез
mirage = міраж
miranda = міранда
mireles = мірелес
mirelez = мірелез
mirelle = мірел
misadventures = місадвенчѵрз
misadventure = місадвенчѵр
misanthropes = місанѳроѵпс
misanthrope = місанѳроѵп
miscarriages = міскаріаџез
mischaracterizations = міскарактеразеішонз
mischaracterization = міскарактеразеішон
mischaracterized = міскарактераізд
mischaracterizes = міскарактераізез
mischaracterize = міскарактераіз
mischaracterizing = міскарактераізінг
misformed = місформед
mislaying = міслеіінг
mispronunciation = міспронънсіеішон
missionaries = мішонаріз
missouri = мізурі
misted = містед
mistitled = містаітелд
misunderstandings = місъндерстандінгз
misunderstanding = місъндерстандінг
misunderstands = місъндерстандз
misunderstand = місъндерстанд
misunderstood = місъндерстѵд
mitochondria = маітокондріа
mitochondrion = маітокондріон
mittened = мітенд
mm = мм
modalities = модалітіз
modality = модаліті
modrak = модрак
moisty = моісті
moleskin = моѵл­скін
mollow = молоѵ
monaco = монако
monette = монет
monomers = мономерз
monomer = мономер
monoplanes = моноплеінз
monoplane = моноплеін
monopoles = монопоѵлз
monopole = монопоѵл
monosaccharide = моносакараід
monosyllables = моносілабелз
monosyllable = моносілабел
monotone = монотоѵн
monotype = монотаіп
montgomerys = монтгомеріз
monuments = моніѵментс
monument = моніѵмент
mooning = мунінг
moored = мурд
mooring = мурінг
moors = мурз
moor = мур
morbidity = морбідіті
mormonism = мормонізем
morosely = мо­роѵслі
morreale = мореале
mosaic = мозеіік
moszkowski = московскі
motherlessness = мъ­ѕерлеснес
mother’ll = мъѕер’л
mouldering = моѵлдерінг
moulthrop = маѵлѳроп
mournfully = морнфѵллі
mournfulness = морнфѵлнес
mouthfuls = маѵѳфѵлз
mouths = маѵѳс # сущ.
mrs = місіз
mr = містер
m’self = м’селф
m’s = м’з
mulhall = мълхал
multiples = мълтіпелз
multiple = мълтіпел
multiplication = мълтіплікеішон
multiplicity = мълтіплісіті
multiplied = мълтіплаід
multiplier = мълтіплаір
multiplies = мълтіплаіз
multiplying = мълтіплаіінг
multiply = мълтіплаі
multivolume = мълтіволіум
mumbling = мъмблінг
mummy’d = мъмі’д
murderess = мърдерес
murjani = мѵрџані
murkiness = мъркінес
murkowski = мѵрковскі
murmured = мърмѵрд
murmuring = мърмѵрінг
murmurs = мърмѵрз
murmur = мърмѵр
musculature = мъскіѵлачѵр
mushrooming = мъшрумінг
mustn’t = мъст’нт
must’ve = мъст’в
mythologize = міѳолоџаіз
mythology = міѳолоџі
m = м
nacogdoches = накогдечез
nacreous = неікреос
naismith = неізміѳ
n’ai = н’э
nape = неіп
napoleonic = неполеонік
napoleon = неполеон
narita = нарита
narodny = народні
narragansett = нарагансет
narrated = нареітед
narrates = нареітс
narrate = нареіт
narration = нареішон
narrators = нареіторз
narrator = нареітор
narrowed = нароѵд
narrower = нароѵер
narrowest = нароѵест
narrowing = нароѵінг
narrowly = нароѵлі
narrowness = нароѵнес
narrows = нароѵз
narrow = нароѵ
nary = нарі
natchitoches = накітош
naturalis = натѵраліс
naughtiness = нѡтінес
nausea = нѡзеа
navas = новас
navigable = навігабел
navigated = навігеітед
navigates = навігеітс
navigate = навігеіт
navigating = навігеітінг
navigational = навігеішонал
navigation = навігеішон
navigators = навігеіторз
navigator = навігеітор
nearness = нірнес
neatening = нитенінг
necklace = неклеіс
neckline = неклаін
needlewoman = нидел-ѵѵман
needn’t = нид’нт
née = не
negropalpus = негрополпѵс
neighbour’s = неібор’с
nemir = немір
nerveless = нървлес
n’est = н’эт
newspapers = ніуспеіперз
newspaper = ніуспеіпер
ne = не
nibbling = ніблінг
niebling = ниблінг
nightdress = наітдрес
nightgown = наітгаѵн
nightie = наіті
nightie = наіті
nobody’ll = ноѵбоді’л
noiselessly = ноізлеслі
nomenklatura = номенклачѵра
nonaccrual = нонакріуал
nonaccruing = нонакріуінг
nondefense = нондефенс
nonintervention = нонінтервеншон
nonplused = нонплъст
nonresponsive = нонреспонсів
nonunionized = ноніуніонаізд
normandy = норманді
northrop = норѳроп
northrup = норѳръп
northumberland = норѳъмберланд
notepad = ноѵтпад
nothdurft = ноѳдѵрфт
notochord = ноѵтокорд
nourished = нърішт
nourishes = нърішез
nourishing = нърішінг
nourishment = нърішмент
nourish = нъріш
nouvelles = нувелз
november = новембер
novgorod = новгород
novices = новісез
nowadays = наѵ­а­деіз
no = ноѵ
nuit = нѵі
numidians = ніумідіанз
numidian = ніумідіан
n = н
obdurate = обдіѵрат
obediently = обидіентлі
obedient = обидіент
obelisk = обеліск
obeyed = обеід
obeying = обеіінг
obeys = обеіз
obey = обеі
obituaries = обічуаріз
obituary = обічуарі
obligated = облігеітед
obligates = облігеітс
obligate = облігеіт
obligating = облігеітінг
obligations = облігеішонз
obligation = облігеішон
oblinger = оѵблінгер
obscurely = обскіурлі
obstacles = обстакелз
obstacle = обстакел
obstinately = обстінатлі
obuchowski = обѵховскі
o’clocks = о’клокс
octagonal = октагонал
octogenarian = октоџенеріан
oddities = одітіз
oddity = одіті
oddness = однес
odorant = оѵдорант
odorless = оѵдорлес
odorous = оѵдорос
offcuts = офкътс
officialdom = офішалдом
off = оф
often = офен
of = ов
oilcloth = оілклоѳ
oilskins = оілскінз
oklahoma = оѵклахоѵма
okurowski = окѵровскі
ok = оѵкеі
oligarchy = олігаркі
oligocene = олігосин
omaha = оѵмаха
omelettes = омлетс
omelette = омлет
once = ѵънс
onomastics = ономастікс
onomastic = ономастік
onomatopeia = ономатопиа
ontological = онтолоџікал
ony = оні
ooooo = ууу
oo = у
opinionated = опініонеітед
opinionate = опініонеіт
opteryx = оптерікс
oracles = оракелз
oracle = оракел
ordinaries = ордінаріз
organismic = організмік
orgie = орџі
origami = орігамі
origins = оріџінз
origin = оріџін
ornamenting = орнаментінг
orphanages = орфанаџез
orphanage = орфанаџ
orphaned = орфанд
orphanhood = орфанхѵд
orphaning = орфанінг
orpingtons = орпінгтонз
orrell = орел
orthogonal = орѳогонал
osteoporosis = остеопороѵсіс
otk = отк
otranto = отранто
oughtn’t = ѡт’нт
ourselves = аѵрселвз
ours = аѵрз
our = аѵр
outweighed = аѵтѵеід
ovaries = оѵваріз
overacker = оѵверакер
overbalanced = оѵвер­баланст
overlarge = оѵверларџ
overleveraged = оѵверлевраџд
overmantels = оѵвермантелз
overmantel = оѵвермантел
oversensitivity = оѵверсенсітівіті
overvalued = оѵверваліуд
overvalues = оѵвер­валіуз
overvalue = оѵвер­валіу
overvaluing = оѵвер­валіуінг
owling = аѵлінг
oxfordshire = оксфордшір
pacular = пакіулар
pagliarulo = паліарѵло
pajamas = паџамаз
pajamas = паџамаз
pajama = паџама
pakora = пакора
palatial = палеішал
palely = пеіллі
paleness = пеілнес
paleontology = пеілеонтолоџі
paler = пеілер
paling = пеілінг
palish = пеіліш
pallor = палор
palms = палмз
palm = палм
panaco = панако
panelled = панелд
pansophic = пансофік
pantheism = панѳеізем
papa = папа
papoose = папус
parakeets = паракитс
parakeet = паракит
parallelograms = паралелограмз
parallelopipeds = паралелепаіпедз
paramilitaries = парамілітаріз
parasol = парасол
pared = перд
pares = перз
pare = пер
paring = перінг
parkay = паркеі
paroxysm = пароксізем
parseque = парсек
parsimonious = парсімоѵніос
parsimony = парсімоѵні
parsque = парск
parterres = партерз
parterre = партер
pasadena = пасадина
pasty = пеісті
pâté = патеі
patrimonial = патрімоѵніал
patrimony = патрімоѵні
pawfuls = пѡфѵлз
pa = па
peaky = пикі
pechacek = пехачек
pecked = пект
peculiarities = пікіуліарітіз
peculiarity = пікіуліаріті
pedigrees = педігріз
pedigree = педігрі
peelings = пилінгс
peewits = пиѵітс
peewit = пиѵіт
pegg’ll = пег’л
pendletons = пенделтонз
penitence = пенітенс
penitentiaries = пенітенчаріз
penpoints = пенпоінтс
pepys = пепіс
perambulator = перамбіѵлеітор
perceptual = персепчѵал
perfect1 = пърфект # прил.
perfect2 = перфект # сущ.
perfect = пърфект
perfume2 = перфіум # гл.
perfume = пърфіум # сущ.
peroration = перореішон
perplexity = перплексіті
perrell = перел
personages = пърсонаџез
personage = пърсонаџ
personal = пърсонал
pessimism = песімізем
pessimistic = песімістік
pessimists = песімістс
pessimist = песіміст
petrakis = петракіс
petrak = петрак
pettishly = петішлі
pettish = петіш
peur = пøр
peux = пø
phenotypes = финотаіпс
phenotype = финотаіп
phenotypic = финотіпік
philanthropies = філанѳропіз
philanthropists = філанѳропістс
philanthropist = філанѳропіст
philanthropy = філанѳропі
philosopheress = філософерес
philosophers = філософерз
philosopher = філософер
philosophies = філософіз
philosophy = філософі
pianola = піанола
pickax = пікакс
pickhatchet = пікхачет
picnickers = пікнікерз
picnicking = пікнікінг
piercingly = пирсінгли
piggledy = пігелді
pilgrimages = пілгрімаџез
pilgrimage = пілгрімаџ
pilgrims = пілгрімз
pilgrim = пілгрім
pillaged = пілаџд
pillagers = пілаџерз
pillager = пілаџер
pillaging = пілаџінг
pillowcase = пілоѵ­кеіс
pinnacle = пінакел
pinpricks = пінпрікс
piratical = паіратікал
pistols = пістолз
pistol = пістол
pithily = піѳілі
pizzerias = питсеріаз
placated = плакеітед
placatingly = плакеітінглі
placatory = плакеіторі
plainness = плеіннес
plangent = планџент
plashing = плашінг
pleasanter = плезантер
pleated = плитед
pleomorphism = плиомофізем
plethora = плеѳора
plimsolls = плімсолз
plip = пліп
plosives = плоѵзівз
pluckily = плъкілі
plumper = плъмпер
plumpness = плъмпнес
plutocrats = пліутократс
plutocrat = пліутократ
pluto’d = пліутоѵ’д
pneumatics = пнѵматікс
pneumatic = пніуматік
pneumonia = пніумоѵніа
pneumonic = пніумонік
pneumo = пніумо
pocahontas = покахонтас
pocketless = покетлес
podiatrist = подаіатріст
pogorzelski = погожелскі
police’ll = полис’л
politer = полаітер
polyacetylene = поліесетілин
polyamide = поліамаід
polyandrous = поліандрос
polyandry = поліандрі
polybutylene = полібіутілин
polycarpic = полікарпік
polycast = полікаст
polychlorinated = поліклорінеітед
polychlorinate = поліклорінеіт
polychrome = полікроѵм
polyesters = поліестерз
polyester = поліестер
polyethylene = поліеѳілин
polyglot = поліглот
polygonal = полігонал
polygram = поліграм
polygraphs = поліграфс
polygraph = поліграф
polyhedrons = поліхидронз
polyhedron = поліхидрон
polyhemoglobin = поліхемоглобін
polymarkers = полімаркерз
polymarker = полімаркер
polymorphic = поліморфік
polymorphism = поліморфізм
polymorph = поліморф
polynomial = поліноѵміал
polyolefin = поліолефін
polyphase = поліфеіз
polypropylene = поліпроѵпілин
polysaccharides = полісакараідз
polysaccharide = полісакараід
polystyrene = полістаірин
polysyllabic = полісілабік
polytechnologies = політекнолоџіз
polytechnology = політекнолоџі
polytech = політек
polytheism = поліѳиізем
polytheistic = поліѳиістік
polytropic = політропік
polyurethane = полііуреѳеін
pomodoro = помодоро
pompadur = помпедѵр
ponderously = пондерослі
portières = портіерз
portraits = портретс
portraiture = портреічѵр
portrait = портрет
possibilities = посібілітіз
possibility = посібіліті
postscript = поѵстскріпт
potful = потфѵл
potting = потінг
pounces = поѵнсес
powerfully = паѵерфѵллі
practised = практіст
practise = практіс
practising = практісінг
prae = пре
pram = прам
prasad = прасад
prearranged = преареінџд
prearranges = преареінџез
prearrange = преареінџ
prearranging = преареінџінг
prefectural = префекчѵрал
preferable = преферабел
preferably = префераблі
preliminaries = прелімінаріз
preludes = преліудз
prelude = преліуд
prematurely = премачѵрлі
premature = премачѵр
premeditated = премедітеітед
premeditate = премедітеіт
premeditation = премедітеішон
prepackaged = препакаџд
prepositions = препозішонз
presentiment = презентімент
presidentialist = презеденчаліст
prestons = престонз
presumably = презіумаблі
presumed = презіумд
presumes = презіумз
presume = презіум
presuming = презіумінг
pretence = претенс
pretendings = претендінгз
preternaturally = претерначѵраллі
prettily = претілі
prexy’s = прексі’с
prexy = прексі
pricking = прікінг
prickling = пріклінг
primaries = праімаріз
prismatic = прізматік
pristinely = прістинлі
pristine = прістин
pritchetts = прічетс
private = праіват
privet = прівет
probabilities = пробабілітіз
probability = пробабіліті
proclivities = проклівітіз
proclivity = проклівіті
productivity = продѵктівіті
professeur = професøр
profound = профаѵнд
proletariat = пролетеріат
promiscuously = проѵміскѵослі
promptitude = промптітіуд
promptness = промптнес
pronunciation = пронънсіеішон
proprietaries = пропраіетаріз
protagonists = протагоністс
protagonist = протагоніст
protectively = протектівлі
protective = протектів
protégée = протеже
protest1 = проѵтест # сущ.
protest2 = протест # сущ.
protestations = протестеішонз
protestation = протестеішон
protocols = проѵтоколз
protocol = проѵтокол
protropin = протропін
protruded = проѵтріудед
provincialism = провінчалізем
publican = пъблікан
publicis = пъблісіс
publicity = пъблісіті
puckered = пѵккеред
puckle = пъкел
punditry = пъндітрі
punjab = пѵнџаб
purim = пѵрім
purportedly = пърпортедлі
purported = пърпортед
purporting = пърпортінг
purposelessness = пърпослеснес
purred = пърд
pursing = пърсінг
pursuant = пѵрсіуант
pursued = пѵрсіуд
pursuers = пѵрсіуерз
pursuer = пѵрсіуер
pursues = пѵрсіуз
pursueth = пѵрсіуѳ
pursue = пѵрсіу
pursuing = пѵрсіуінг
pushchair = пѵшчер
puttied = пътід
putting = пѵтінг
pyjamas = піџамаз
pythagorus = піѳагорѵс
p = п
qantas = кантас
quadrangle = кѵадрангел
quailed = кѵеілд
quandaries = кѵондаріз
quandary = кѵондарі
quantitatively = кѵантітеітівлі
quare = кѵер
quarrelled = кѵорелд
quarrelling = кѵорелінг
quarried = кѵоррід
quartered = кѵортеред
queerest = кѵірест
quelque = кэлке
que = ке
quibbling = кѵіблінг
quills = кѵілз
quintus = кѵінтѵс
quivered = кѵіверд
q = к
racecourses = реіс­корсез
racialism = реішалізем
radowski = радовскі
raffia = рафіа
rafsanjani = рафсанџані
raiment = реімент
rainproof = реінпруф
rakiya = ракіа
rakocy = ракочі
rakoczy = ракочі
rakolta = раколта
rakovica = раковітса
rakowski = раковскі
rapidity = репідіті
rarin = реірін
rasnake = раснакі
rasping = распінг
ravaged = раваџд
ravaging = раваџінг
ravenously = равенослі
ravished = равішт
raze = реіз
reactionaries = реакшонаріз
read2 = ред # прош.вр.
reading = ридінг
reads = ридз
read = рид
reaffirmation = реафірмеішон
realamerica = риаламеріка
realcap = риалкап
realer = риалер
realestate = риалестеіт
reale = реал
realigned = реалаінд
realigning = реалаінінг
realignments = реалаінментс
realignment = реалаінмент
realign = реалаін
realised = риалаізд
realise = риалаіз
realising = риалаізінг
realism = риалізем
realistically = риалістікаллі
realistic = риалістік
realists = риалістс
realist = риаліст
realities = риалітиз
reality = риаліті
realizable = риалаізабел
realizations = риалезеішонз
realization = риалезеішон
realized = риалаізд
realizes = риалаізез
realize = риалаіз
realizing = риалаізінг
reali = реалі
reallocated = реалокеітед
reallocate = реалокеіт
reallocating = реалокеітінг
reallocation = реалокеішон
reallowance = реалаѵанс
really = риаллі
realpolitik = реалполітік
realtors = риалторз
realtor = риалтор
realty = риалті
real = риал
reauthorization = реѡѳорізеішон
reauthorized = реѡѳораізд
reauthorize = реѡѳораіз
reauthorizing = реѡѳораізінг
recalibrating = рекалібреітінг
recalled = реколд
recalling = реколінг
recalls = реколз
recall = рекол
recapitalization = рекапіталізеішон
recapitalized = рекапіталаізд
recapitalize = рекапіталаіз
recapitalizing = рекапіталаізінг
recapitulates = рекапічѵлеітс
recapitulate = рекапічѵлеіт
recaps = рекапс
recap = рекап
receptacle = ресептакел
recherché = решэрше
rechristened = рекрісенд
rechristen = рекрісен
recipies = ресіпіз
reclosed = реклосед
reclosed = реклоѵзд
recombined = рекомбаінд
recombine = рекомбаін
reconditioned = рекондішонд
reconditioning = рекондішонінг
recondition = рекондішон
reconfigured = реконфігіурд
reconfigure = реконфігіур
reconfirmation = реконфірмеішон
reconfirmed = реконфърмд
reconfirm = реконфърм
reconnoiter = реконоітер
reconsidered = реконсідерд
reconsidering = реконсідерінг
reconsider = реконсідер
reconstructed = реконстръктед
reconstructing = реконстръктінг
reconstructions = реконстръкшонз
reconstruction = реконстръкшон
reconstructive = реконстръктів
reconstruct = реконстръкт
recon = рекон
recounts = рекаѵнтс
recourse = рекорс
reddening = реденінг
redefined = редефаінд
redefines = редефаінз
redefine = редефаін
redefining = редефаінінг
redistributed = редістрібіѵтед
redistribute = редістрібіѵт
redistributing = редістрібіѵтінг
redistributive = редістрібіѵтів
redoubling = редъблінг
redrafted = редрафтед
reëlected = риелектед
reëxaminations = риекзамінеішонз
reëxamination = риегзамінеішон
refaced = рифеіст
refolded = рефоѵлдед
refractive = рефрактів
refractories = рефракторіз
refractors = рефракторз
refractory = рефракторі
refractor = рефрактор
refrained = рефреінд
refraining = рефреінінг
refrains = рефреінз
refrain = рефреін
refrigerants = рефріџерантс
refrigerant = рефріџерант
refrigerated = рефріџереітед
refrigerate = рефріџереіт
refrigeration = рефріџереішон
refrigerators = рефріџереіторз
refrigerator = рефріџереітор
regenerated = реџенереітед
regenerate = реџенереіт
regenerating = реџенереітінг
regeneration = реџенереішон
registrants = раџістрантс
registrant = раџістрант
registrars = раџістрарз
registrar = раџістрар
registrations = реџістреішонз
registration = реџістреішон
reincorporate = реінкорпореіт
reincorporating = реінкорпореітінг
reincorporation = реінкорпореішон
reinvigorated = реінвігореітед
reinvigorate = реінвігореіт
reinvigorating = реінвігореітінг
reinvigoration = реінвігореішон
relight = релаіт
reloral = релорал
remarriage = ремаріаџ
remarried = ремарід
remarrying = ремаріінг
remarry = ремарі
rembrandts = рембрантс
rembrandt = рембрант
remembrances = ремембренсез
remembrance = ремембранс
remunerate = реміунереіт
remuneration = реміунереішон
remunerative = реміунератів
rend = ренд
repassed = репаст
repasses = репасез
repassing = репасінг
repass = репас
rephrase = рефреіз
replaceable = реплеісабел
replaced = реплеіст
replace = реплеіс
represses = репресез
repressively = репресівлі
reprimanded = репрімандед
reprimands = репрімандз
reprimand = репріманд
reproaches = репроѵчез
reproving = репрувінг
require = рекѵаір
rereading = реридінг
reread = рерид
resembling = реземблінг
reshelved = решелвд
resignation = резігнеішон
resounded = резаѵндед
resounding = резаѵндінг
resounds = резаѵндз
resound = резаѵнд
respectueux = респектѵø
responsibilities = респонсібілітіз
responsibility = респонсібіліті
restaurants = ресторантс
restaurant = ресторант
restfulness = реcтфѵлнес
restrung = ристрънг
resumed = резіумд
resumes = резіумз
resume = резіум
resuming = резіумінг
retch = реч
retorting = ретортінг
retourner = ретурне
retractable = ретрактабел
retracted = ретрактед
retracting = ретрактінг
retraction = ретракшон
retracts = ретрактс
retract = ретракт
retrocessionaries = ретроѵсешонаріз
retrograde = ратрогреід
reunification = реіуніфікеішон
reunified = реіуніфаід
reunify = реіуніфаі
reunions = реіуніонз
reunion = реіуніон
revealment = ревилмент
revengeful = ревенџфѵл
review = ревіу
revolucionario = револѵсіонаріо
revolutionaries = револіушонаріз
rheumatics = ріуматікс
rheumatic = ріуматік
rhubarb = рубарб
ribboned = рібонд
rightened = ръітенд
right = ръіт
rigidity = ріџідіті
rigmarole = рігмарол
rigorously = рігорослі
rigorous = рігорос
rimed = раімд
rime = раім
ringbinding = рінгбаіндінг
ringlets = рінглетс
rinsed = рінст
rivulets = рівіѵлетс
rivulet = рівіѵлет
roadworks = роѵдѵъркс
robling = роѵблінг
robustas = робѵстас
rodefer = родефер
rodeffer = родефер
roly = ролі
romps = ромпс
rooty = руті
rosebuds = роѵзбъдз
rostenkowski = ростенковскі
rostropovich = ростропоѵвіч
rottenness = ротеннес
rouen = рѵан
roughened = ръфенд
roughen = ръфен
roundabout = раѵнд­абаѵт
rousseau = русѡ
rowlocks = роѵлокс
rowlock = роѵлок
royalist = роіаліст
royall = роіал
royalties = роіалтіз
royalty = роіалті
r’s = р’з
rubbishy = ръбіші
rumblings = ръмблінгз
rumbling = ръмблінг
ruminatively = румінатівлі
ruminative = румінатів
runacre’s = рѵнеікер’с
runacre = рѵнеікер
runaround = рънараѵнд
rural = ріурал
rusnak = ръснак
rustled = ръселд
rutherford = ръѕерфорд
r = р
saccharine = сакараін
saccharin = сакарін
sackcloth = сакклоѳ
sadaka = садака
sadao = садао
saddoris = садоріс
sadella = садела
sadistic = садістік
sadlowski = садловскі
sadowski = садовскі
sadowsky = садовскі
saguaro = сагѵаро
said = сед
sails = се́ілз
sail = се́іл
salvageable = салваџабел
salvaged = салваџд
salvagers = салваџерз
salvager = салваџер
salvaging = салваџінг
salvesen = салвесен
salvigsen = салвігсен
sam’ll = сам’л
sam’l = сам’л
samphire = самфаір
sanctuaries = санкчуаріз
sandalwood = сандал-ѵѵд
sandcastles = сандкаселз
sandcastle = сандкасел
sandefer = сандефер
sandhills = сандхілз
sandpiper = сандпаіпер
sandshoes = сандшуз
sandshoe = сандшу
sanfer = санфер
santas = сантас
sare = сер
sassed = саст
satchel = сачел
saturday = сатѵрдеі
saucepans = сѡс­панз
savaged = саваџд
savagely = саваџлі
savagery = саваџері
savaging = саваџінг
saw = сѡ
says = сез
scabby = скабі
scaldingly = сколдінглі
scampy = скампі
scandalously = скандалослі
scatological = скатолоџікал
scavenged = скавенџд
scenarios = сінаріоз
scenario = сінаріо
scenes = си́нз
scene = си́н
sceptics = скептікс
sceptic = скептік
schabacker = шабакар
schacher = шахер
schaecher = шехер
schaible = скеібел
schanbacher = шанбахар
schoolgirls = скулгърлз
schoolmistresses = скулмістресез
schoolmistress = скулмістрес
schopenhauer = шопенхаѵер
scoldings = скоѵлдінгз
scornfully = скорнфѵллі
scrabbled = скрабелд
scrabbling = скраблінг
scrambling = скрамблінг
scrawly = скрѡлі
scribbling = скріблінг
scribbly = скріблі
scriptum = скріптѵм
scullery = скълері
scurvy = скърві
seabirds = сиібърдз
seabird = сиібърд
seagulls = сиігълз
seagull = сиігъл
seasick = сиісік
seasides = сиісаідз
seaside = сиісаід
seas = сиіз
seaweeds = сиіѵидз
seaweed = сиіѵид
sea = сиі
secondaries = секондаріз
secretaries = секретаріз
secreting = сикретінг
see’d = си’д
seemingless = симінглес
seemly = симлі
seismic = саізмік
seismological = саізмолоџікал
seismologists = саізмолоџістс
seismologist = саізмолоџіст
seismology = саізмолоџі
sekerak = секерак
selfportrait = селфпортрет
semaphore = семафор
semiautomatic = семіѡтоматік
seminarians = семінаріанз
seminarian = семінаріан
seminaries = семінаріз
seminario = семінаріо
semples = семпелз
semple = семпел
senectute = сенектѵте
sennott = сенот
separators = сепареіторз
separator = сепареітор
septicaemia = септісиміа
septuagenarian = сепчуаџенеріан
sepulchral = сепълкрал
serially = серіаллі
serial = сіріал
serowski = серовскі
serviceable = сървісабел
serviceman = сървісман
servicemen = сървісмен
services = сървісез
sesame = сесаме
setterfield = сетерфилд
several = северал
shadur = шадѵр
shakily = шеікілі
shallows = шалоѵз
shamanism = шеіманізем
shan’t = ша’нт
sharpener = шарпенер
she’d = ши’д
sheeted = шитед
she’ll = ши’л
shepherdess = шепердес
she’s = ши’з
shinny = шіні
shipwrecked = шіпрект
shipwrecks = шіпрекс
shoemaking = шумеікінг
shortlisted = шортлістед
shouldn’t = шѵд’нт
shrilled = шрілд
shrilly = шрілі
shrimping = шрімпінг
shrivelling = шрівелінг
shrubberies = шръберіз
shushing = шъшінг
shush = шъш
sibilants = сібілантс
sideboards = саідбордз
sideboard = саідборд
sieved = сівд
sighed = саід
signatures = сігначѵрз
signature = сігначѵр
significance = сігніфіканс
significant = сігніфікант
silhouetted = сілуетед
silhouettes = сілуетс
silhouette = сілует
sillabub = сілабъб
silly = сілі
simoneaux = сімонѡ
simoneau = сімонѡ
simonette = сімонет
simonet = сімонет
simonin = сімонін
simonis = сімоніс
simony = саімоні
simpering = сімперінг
singlehanded = сінгел­хандед
sinnott = сінот
skenandore = скінандор
skilfully = скілфѵллі
skulking = скълкінг
skywards = скаіѵордз
slantwise = слантѵаіз
sleepwrite = слипраіт
sleighs = слеіз
slewed = сліуд
slighter = слаітер
slinking = слінкінг
slithered = сліѕерд
sloes = слоѵз
slonaker = слонакер
slunk = слънк
smouldering = смоѵлдерінг
smudges = смъџез
smutch = смъч
sneezy = снизі
snipped = сніпт
snipping = сніпінг
snivelling = снівелінг
snowdrops = сноѵдропс
snowlocked = сноѵлокт
snuffboxes = снъфбоксез
snuffbox = снъфбокс
snuffled = снъфелд
snuggled = снъгелд
soaped = соѵпт
soberer = соберер
socialism = соѵшалізем
socialistic = соѵшалістік
socialists = соѵшалістс
socialist = соѵшаліст
socialites = соѵшалаітс
socialite = соѵшалаіт
socialization = соѵшалізеішон
socialized = соѵшалаізд
socialize = соѵшалаіз
socializing = соѵшалаізінг
societal = сосаіетал
societies = сосаіетіз
society = сосаіеті
solidity = солідіті
somatotropin = соѵматотропін
sombre = сомбер
somewhere = съм­ѵер
sophisticated = софістікеітед
sophisticates = софістікатс
sophisticate = софістікеіт
sophistication = софістікеішон
sophomores = софоморз
sophomore = софомор
soporific = сопоріфік
sorceress = сорсерес
sorrowfully = сороѵфѵллі
sorrowfulness = сороѵфѵлнес
sorrowful = сороѵфѵл
sorrowing = сороѵінг
sorrows = сороѵз
sorrow = сороѵ
sorry = сорі
soughing = съфінг
sough = съф
soulmate = соѵлмеіт
soundless = саѵндлес
southworth = саѵѳѵорѳ
sou’westers = саѵ-ѵестерз
sou’wester = саѵ-ѵестер
so = соѵ
spared = сперд
spares = сперз
spare = спер
sparing = сперінг
spartacus = спартакѵс
speciale = спечалі
specialists = спешалістс
specialist = спешаліст
specialities = спешалтіз
specialization = спешалезеішон
specialized = спешалаізд
specializes = спешалаізез
specialize = спешалаіз
specializing = спешалаізінг
specialties = спешалтіз
specialty = спешалті
spectacles = спектакелз
spectacle = спектакел
spectrally = спектраллі
spectres = спектерз
spectrograph = спектрограф
spelt = спелт
spindly = спіндлі
spinsters = спінстерз
spiritualism = спірічѵалізем
spirituality = спірічѵаліті
spiritually = спірічѵаллі
spirituals = спірічѵалз
spiritual = спірічѵал
splayed = сплеід
splinters = сплінтерз
splodges = сплоџез
splodge = сплоџ
spluttering = сплътерінг
splutter = сплътер
spoilt = споілт
spookiness = спукінес
spools = спулз
spooned = спунд
spooning = спунінг
sporadically = спорадікаллі
sporadic = спорадік
sprigs = спрігз
sprig = спріг
springy = спрінгі
sprinkly = спрінклі
squabbling = скѵоблінг
squatted = скѵотед
squawked = скѵѡкт
squinted = скѵінтед
squirmy = скѵърмі
ssh = шш
sssh = шшш
s’s = с’з
staccato = стакато
stairs = стеірз
stairways = стеір­​ѵеіз
stairway = стеір­​ѵеі
stair = стеір
staithe = стеіѳ
stalnaker = сталнакер
stammered = стамерд
standefer = стандефер
steadying = стедіінг
stealthily = стелѳілі
steeling = стилінг
stepanakert = степанакерт
stephanie = стефані
stephani = стефані
stephanopoulos = стефанопѵлос
stereognathus = стереогнаѳѵс
stirrups = стірепс
stirrup = стіреп
stoats = стоѵтс
stoat = стоѵт
stochastic = стокастік
stockinged = стокінгд
stoical = стоікал
stolarski = столарскі
stolidly = столідлі
stonebraker = стоѵнбреікер
stonework = стоѵнѵърк
stonily = стоѵнілі
storerooms = стор­румз
storeys = сторіз
stowing = стоѵінг
st petersburg = сент-питерзбѵрг
straggly = страглі
straingers = стреінџерз
stratacom = стратаком
strengths = стренгѳс
strength = стренгѳ
streptococcus = стрептококѵс
stribling = стріблінг
studdingtons = стъдінгтонз
studdington = стъдінгтон
stumbling = стъмблінг
stupefied = стіупефаід
stupefies = стіупефаіз
stupefying = стіупефаіінг
stupefy = стіупефаі
stuttered = стѵттеред
st = ст
subcommittee = събкоміти
subdivide = събдіваід
subject2 = сѵбџект # гл.
subjects = събџектс
subject = събџект # сущ., прил.
sublingual = сѵблінгѵал
subsidiaries = сѵбсідіаріз
subter = сѵбтер
suburbanites = сѵбърбанаітс
suburbanite = сѵбърбанаіт
suburbanization = сѵбърбанізеішон
suburbanize = сѵбърбанаіз
suchanek = сѵханек
suchlike = съчлаік
sue’s = сіу’с
sufferance = съферанс
suis = сѵі
sulked = сълкт
sulking = сълкінг
sulks = сълкс
sulky = сълкі
sulk = сълк
sullenly = съленлі
summaries = съмаріз
summoned = съмонд
summonsed = съмонзд
sunburnt = сънбърнт
sunniest = съніест
sun’s = съ́н’с
sun = съ́н
superfluidity = сіуперфліуідіті
superfluity = сѵперфлѵіті
superimposed = сіуперімпоѵзд
superimpose = сіуперімпоѵз
superintend = сіѵперінтенд
superiores = сѵперіорес
superiors = сіупіріорз
superior = сіупіріор
supernaturally = сіуперначѵраллі
surely = шурлі
sure = шур
surliness = сърлінес
surrealisms = сѵриаліземз
surrealism = сѵриалізем
surrealistic = сѵриалістік
surreal = сѵриал
susan = сіузан
sussuration = сѵсѵреішон
swaddled = сѵаделд
swaddle = сѵадел
swathed = сѵеіѕд
swathes = сѵеіѕз
swathe = сѵеіѕ
swathing = сѵеіѕінг
swatter = сѵотер
swivelled = сѵівелд
sybillas = сібілаз
symptomatic = сімптоматік
synnott = сінот
synonyms = сінонімз
syracuse = сіракіуз
syrups = сіръпс
syrup = сірѵп
s = с
tablature = таблачѵр
tabling = теіблінг
tabulature = табіѵлачѵр
tacoma = такоѵма
taj = таџ
tallish = толіш
tallness = толнес
tardily = тарділі
tarrytown = тарітаѵн
tarry = тарі
tasaday = тасадеі
tassells = таселз
tassell = тасел
tautened = тѡтенд
tauten = тѡтен
teapots = типотс
tear2 = тер # рвать
teardrops = тірдропс
teardrop = тірдроп
tears2 = терз # рвать
tears = тірз # слеза
tear = тір # слеза
teashop = тишоп
tea’s = ти’з
telescoped = телескоѵпт
telly = телі
temperatures = темпрачѵрз
temperature = темпрачѵр
temperedly = темпердлі
temporally = темпораллі
temporal = темпорал
temporaries = темпераріз
temporarily = темпорарілі
temporary = темпорарі
temporize = темпораіз
temporizing = темпораізінг
tensing = тенсінг
tentacles = тентакелз
tentacle = тентакел
tenterhooks = тентерхѵкс
tenterhook = тентерхѵк
tenus = тенѵс
terminator = търмінеітор
terracotta = теракота
territorialism = теріторіалізем
territorially = теріторіаллі
territorial = теріторіал
territories = теріторіз
territory’s = теріторі’c
territory = теріторі
textual = тексчѵал
that’d = ѕат’д
that’ll = ѕат’л
that’s = ѕат’з
theatergoers = ѳіатергоѵерз
theatergoer = ѳіатергоѵер
theaters = ѳіатерз
theater’s = ѳіатер’с
theater = ѳіатер
theatres = ѳіатерз
theatre = ѳіатер
theatricality = ѳіатрікаліті
theatrically = ѳіатрікаллі
theatricals = ѳіатрікалз
theatrical = ѳіатрікал
theatrics = ѳіатрікс
theatric = ѳіатрік
theirs = ѕеірз
their = ѕеір
theodora = ѳиодора
theodorou = ѳеодорѵ
theorems = ѳіоремз
theorem = ѳіорем
theoretically = ѳіоретікаллі
theoretical = ѳіоретікал
theoreticians = ѳіоретішанз
theoretician = ѳіоретішан
theoretics = ѳіоретікс
theoretic = ѳіоретік
theories = ѳіоріз
theory = ѳіорі
thereof = sер-ов
there’s = ѕер’з
they’d = ѕеі’д
they’ll = ѕеі’л
they’re = ѕеі’р
they’ve = ѕеі’в
thickness = ѳік­нес
thimbles = ѳімбелз
things’ll = ѳінгз’л
thinnish = ѳініш
thirty’s = ѳърті’с
thirty = ѳърті
thoreau = ѳорѡ
thorup = ѳоръп
threemonth = ѳримънѳ
threshing = ѳрешінг
throbbed = ѳробд
throwaways = ѳроѵ-аѵеіз
throwaway = ѳроѵ-аѵеі
th = ѳ
tib’s = тіб’с
tib = тіб
tickling = тіклінг
tidied = таідід
tidily = таіділі
tidying = таідіінг
tiffs = тіфс
timidity = тімідіті
timoney = тімоні
tingled = тінгелд
tinturn = тінтѵрн
tirrell = тірел
titled = таітелд
titles = таітелз
title = таітел
tittsworth = тітсѵорѳ
today = тѵдеі
todoroff = тодороф
together = тѵгеѕер
toledo = толидо
tomorrow = тѵмороѵ
tonight = тѵнаіт
tonsilitis = тонсілітіс
toothaches = туѳеікс
toothache = туѳеік
tooting = тутінг
topmost = топмоѵст
torchlight = торчлаіт
tortoiseshell = тортесшел
tortoises = тортесез
tortoise = тортес
totted = тотед
t’oublierai = т’убліре
tousled = таѵзелд
tousle = таѵзел
towards = тѵ-ѵордз
toward = тѵ-ѵорд
to = тѵ
traditionalists = традішоналістс
trances = трансез
tranquillity = транкѵіліті
tranquilly = транкѵіллі
transference = трансфъренс
transliterator = транслітереітор
translucence = трансліусенс
transparencies = транспаренсіз
transparency = транспаренсі
transparently = транспарентлі
transparent = транспарент
trapdoor = трапдор
trapezoids = трапезоідз
trasimenus = тразіменѵс
travestied = травестід
tregoning = трегонінг
tremblingly = тремблінглі
trembling = тремблінг
tremont = тремонт
tres = тре
très = трэз
triage = траіаџ
tribalism = траібалізем
tributaries = трібіѵтеріз
tributary = трібіѵтарі
tributes = трібіѵтс
tribute = трібіѵт
trigonometry = трігонометрі
trills = трілз
tripler’s = траіплер’c
trnopolje = тернополіе
troilus = троілѵс
trollope’s = тролоп’с
trollope = тролоп
troubling = тръблінг
trousseau = трусѡ
trowel = траѵел
truants = тріуантс
trunkfuls = трънкфѵлз
trunkful = трънкфѵл
tsze = тсзе
tullus = тѵлѵс
tumbling = тъмблінг
tuneless = тіун­лес
turbidity = търбідіті
turbid = търбід
tureen = тѵрин
turnarounds = търнараѵндз
turnaround = търнараѵнд
tuscaloosa = тъскалуса
tutting = тътінг
twardowski = твардовскі
twa = тѵа
twinness = тѵіннес
twinship = тѵіншіп
twirly = тѵърлі
two = тѵу
tymor = таімор
tyres = таірз
ultraconservative = ълтраконсърватів
ululation = іѵліѵлеішон
unaccompanied = ънакомпанід
unaccountable = ънакаѵнтабел
unaccountably = ънакаѵнтаблі
unaccounted = ънакаѵнтед
unaccredited = ънакредітед
unacknowledged = ънакнолеџд
unafraid = ънафреід
unambiguous = ънамбігіѵос
unapproachable = ънапроѵчабел
unaudited = ънѡдітед
unauthorized = ънѡѳораізд
unblinking = ънблінкінг
unblunted = ънблънтед
unbrotherly = ънбръѕерлі
uncharacteristically = ънкарактерістікаллі
uncharacteristic = ънкарактерістік
uncheerful = ънчірфѵл
uncleaned = ънклинд
uncommonly = ънкомонлі
unconcernedly = ънконсърндлі
unconsoling = ънконсоѵлінг
uncurtained = ънкъртенед
undamaged = ъндамаџд
undefeated = ъндефитед
undefined = ъндефаінд
underclothes = ъндер­клоѵѕз
underfed = ъндерфед
undergardener = ъндергарденер
undergraduates = ъндерграџѵатс
undergraduate =  ъндерграџѵат
underhand = ъндерханд
underhousemaid = ъндерхаѵсмеід
undersides = ъндер­саідз
undertakers = ъндертеікерз
undiscommoded = ъндіскомоѵдед
undismayed = ъндісмеід
undistributed = ъндістрібіѵтед
undivided = ъндіваідед
undressing = ъндресінг
undulations = ѵндѵлеішонз
undulation = ѵндѵлеішон
uneaten = ънитен
unedited = ънедітед
unenthusiastically = ъненѳѵзіастікаллі
unfamiliarities = ънфаміліарітіз
unfamiliarity = ънфаміліаріті
unfastened = ънфасенд
unfound = ънфаѵнд
unfruitful = ънфріутфѵл
ungentlemanly = ънџентелманлі
ungrammatical = ънграматікал
ungreedily = ън­гриді­лі
ungrudging = ънгръџінг
unhooked = ънхѵкт
unhoped = ънхоѵпт
unhurried = ънхърід
unhygienic = ънхаіџинік
unincorporated = ънінкорпореітед
unintermittently = ънінтермітентлі
uniondale = іуніондеіл
unionfed = іуніонфед
unionism = іуніонізем
unionists = іуніоністс
unionist = іуніоніст
unionization = іуніонізеішон
unionized = іуніонаізд
unionize = іуніонаіз
unionizing = іуніонаізінг
unitas = ѵнітас
unkemptness = ънкемптнес
unkindly = ън­каіндлі
unlatched = ънлачт
unleveraged = ънлевраџд
unlighted = ънлаітед
unlit = ънліт
unmanly = ънманлі
unmarried = ънмарід
unmelodic = ънмелодік
unmoving = ънмувінг
unmusical = ънміузікал
unobtrusively = ънобтріусівлі
unopposed = ънопоѵзд
unpiano = ънпіано
unpicked = ънпікт
unpick = ънпік
unplayed = ънплеід
unpropitious = ънпропішос
unrattled = ънрателд
unravelling = ънравелінг
unrealistic = ънриалістік
unreality = ънриаліті
unreal = ънриал
unreasonable = ънризонабел
unreasoning = ънризонінг
unreservedly = ънрезерведлі
unresisting = ънрезістінг
unresponsive = ънреспонсів
unrested = ънрестед
unreturning = ънретърнінг
unruliness = ън­ріу­лінес
unscholarly = ънсколарлі
unscrewed = ънскріуд
unscrubbed = ънскръбд
unseasoned = ънсизонед
unseeing = ънсиінг
unserviceable = ънсървісабел
unsociable = ънсоѵшабел
unsophisticated = ънсофістікеітед
unstick = ънстік
unstressed = ънстрест
unsubstantiated = ънсѵбстанчіеітед
unsurprised = ънсърпраізд
unsworth = ънсѵорѳ
untrammelled = ънтрамелд
untrust = ънтръст
untuned = ънтіунд
untwins = ънтѵінз
unwell = ънѵел
unwrinkled = ънрінкелд
upset = ъпсет
upturned = ъптърнд
urbanism = ърбанізем
urbanites = ърбанаітс
urbanite = ърбанаіт
urbanization = ърбанезеішон
urbanized = ърбанаізд
urbanize = ърбанаіз
use2 = іуз # гл.
usea = іуса
uselessly = іуслеслі
uses2 = іузез # гл.
uses = іусез # сущ.
use = іус # сущ.
us’ll = ъс’л
v2 = v
vacation’s = вакеішон’з
vacations = вакеішонз
vacation = вакеішон
vailima = ваіліма
valance = валанс
validity = валідіті
valuables = ва­ліѵ­а­белз
valuable = ва­ліѵ­а­бел
vanaken = ванакен
vanarsdale = ванарздеіл
vangorden = вангорден
vangorder = вангордер
vangorp = вангорп
vanwagoner = ванѵагонер
vaporization = веіпорізеішон
vaporized = веіпораізд
vaporize = веіпораіз
vaporware = веіпорѵер
varela = варела
varick = веірік
varied = веірід
varies = веіріз
vary = веірі
vassilios = васіліос
vassily = васілі
vaster = вастер
veined = веінд
vellum = велѵм
velveting = велветінг
venacuro = венакіѵро
venereal = вениреал
venomous = веномос
verbiage = върбіаџ
vergeless = върџлес
verisimilitude = верісімілітіѵд
verrell = верел
vertiginous = въртіџінос
veterinarians = ветрінеріанз
veterinarian = ветрінеріан
vexation = вексеішон
vibrated = ваібреітед
vicinity = вісініті
vient = віен
vigorously = вігорослі
vigorous = вігорос
viii = viii
vii = vii
vileness = ваілнес
villagers = вілаџерз
villager = вілаџер
villarreal = вілареал
virtuous = върчѵос
visigoths = візігоѳс
visigoth = візігоѳ
visionaries = віжонаріз
vitalized = ваіталаізд
vitalize = ваіталаіз
vi = vi
vivisepulture = вівісепѵлчѵр
vnesheconombank = венешекономбанк
vocations = вокеішонз
vocation = вокеішон
voila = вѵала
volkogonov = волкогонов
vol = вол
vondrak = вондрак
voom = вум
votre = вотр
voyaged = воіаџд
v = в
wadsworth = ѵодзѵорѳ
waggoner = ѵагонер
wagner = вагнер
wagoneers = ѵагонірз
wagoneer = ѵагонір
wagoner = ѵагонер
wainscot = ѵеінскот
wakefulness = ѵеікфѵлнес
waldrup = ѵолдръп
walkabout = ѵѡкабаѵт
walked = ѵѡкт
walker = ѵѡкер
walking = ѵѡкінг
walks = ѵѡкс
walk = ѵѡк
wallflowers = ѵолфлаѵерз
walsworth = ѵолсѵорѳ
walworth = ѵолѵорѳ
wanderthirst = ѵандерѳърст
wanly = ѵонлі
warbling = ѵорблінг
wardrobes = ѵорд­роѵбз
wardrobe = ѵорд­роѵб
warnaco = ѵорнако
warn’t = ѵор’нт
wasn’t = ѵоз’нт
waters = ѵотерз
waterworth = ѵотерѵорѳ
water = ѵотер
wavelets = ѵеівлетс
wavelet = ѵеівлет
waywardness = ѵеіѵорднес
wear = ѵе́р
weatherbeaten = ѵеѕербитен
we’d = ѵи’д
weekends = ѵик­ендз
weekend = ѵик­енд
weighed = ѵеід
weight = ѵе́іт
welcomes = ѵелкъмз
welkin = ѵелкін
we’ll = ѵи’л
wench = ѵенч
weren’t = ѵър’нт
we’re = ѵи’р
were = ѵър
wernimont = ѵърнімонт
westrup = ѵестръп
we’ve = ѵи’в
we = ѵи
whatever = ѵот­е­вер
what’re = ѵот’р
what’s = ѵот’з
whereabouts = ѵер­а­баѵтс
where’s = ѵер’з
whichever = ѵіч­евер
whimpered = ѵімперд
whimpers = ѵімперз
whined = ѵаінд
whirr = ѵъ́р
whisperings = ѵісперінгз
whist = ѵіст
whitacre = ѵітакер
whitened = ѵаітенд
whittall = ѵітал
who’d = ху’д
whole = хоѵл
who’ll = ху’л
who’re = ху’р
who’s = ху’з
who’ve = ху’в
whyever = ѵаіевер
wid = ѵід
wiedersehen = відерзеен
wilbanks = ѵілбанкс
wilful = ѵілфѵл
willowy = ѵілоѵі
windie = ѵінді
windowsill = ѵіндоѵсіл
wineglasses = ѵаінгласез
wineglass = ѵаінглас
winterman = ѵінтерман
winthrop = ѵінѳроп
wisman = ѵізман
wisps = ѵіcпс
witchhazel = ѵічхеізел
without = ѵіѕ­аѵт
witticisms = ѵітісіземз
witticism = ѵітісізем
wobbling = ѵоблінг
wojnarowski = воінаровскі
wojnowski = воіновскі
wojtas = воітас
wojtkowski = воітковскі
womanly = ѵѵманлі
wonderingly = ѵъндерінглі
wonderings = ѵъндерінгз
wonky = ѵонкі
wonnacott = ѵънакот
won’t = ѵо’нт
woods = ѵудз
wood = ѵуд
wordsworth’s = ѵърдзѵорѳ’с
wordsworth = ѵърдзѵорѳ
wore = ѵо́р
worldview = ѵърлдвіу
wormed = ѵърмд
wot’s = ѵот’з
wot = ѵот
wouldn’t = ѵѵд’нт
wrapps = рапс
wriggled = рігелд
wriggling = ріглінг
wrongfooted = ронгфѵтед
wuntermenny’s = ѵънтермені’с
wuntermenny = ѵънтермені
xs = хс
yachters = іаатерз
yachter = іаатер
yachting = іаатінг
yachtsman = іаатсман
yachtsmen = іаатсмен
yachts = іаатс
yachts = іаатс
yacht = іаат
yearly = іирлі
years = іирз
year’s = іир’с
year = іир
yellowed = іелоѵд
yelps = іелпс
yews = іуѵз
yew = іуѵ
yince = іінс
yiyun = иіун
you’d = іу’д
you’ll = іу’л
youngish = іънгіш
you’re = іу’р
yourself = іорселф
yours = іорз
you’ve = іу’в
yowl = іаѵл
zabowski = забовскі
zabriski = забріскі
zacarias = закаріаз
zachariah = закараіа
zacharias = закараіас
zagging = загінг
zbikowski = збіковскі
zebedee = зебеди
zelenak = зеленак
zested = зестед

