# Мой словарик
a = э
ah = а
aiuto = аюто
am = эм
are = ар
asked = эскт
actual = экчуал
actually = экчуалли
and = энд
anxious = энкшес
asap = эсэп
attaché = атташе
awful = о́фул
b = б
bartleby = бартлби
bartleby’s = бартлби’с
beddie = бедди
bedrock = бед­рок
blankie = блэнки
booke = бук
bosun = боусун
bought = бо́т
briend = бренд
brindisi = бриндизи
c = к
cahartez = каартез
cause = ко́з
christchurch = крайстчёрч
chi = чи
chix = чикс
choir = кўэйр
cia = си-ай-э̀й
ciao = чао
clawlike = кло́лайк
cliché = клише
clichéd = клишед
clichés = клишез
clopped = клопт
clopping = клоппинг
cnn = си́-э̀н-э̀н
cnn’s = си́-э̀н-э̀н’с
comin = камин
command = комманд
compensator = компенсейтор
complexion = комплекшен
complexions = комплекшенз
conchlike = кончлайк
concusser = конкассер
concussor = конкассор
craic = кракь
cudgeon = каджон
d = д
dea = ди́-и́-эй
dearie = дири
dé = де
ditchwater = дитчўотер
does = даз
doin = ду́ин
doorknob = дорноб
dna = ди-э̀н-э̀й
dr = др
e = е
éiriú = э́рю́
eoin = оуин
eurosat = ю́росат
excuse = э̀кскью́з
excuse1 = э̀кскью́с
excuse2 = э̀кскью́з
f = ф
fáil = фа́ль
fbi = э̀ф-би́-ай
fifth = фифҫ
foaly = фоули
foaly’s = фоули’с
fóle = фо́л
franca = франка
from = фром
g = г
gedds = геддз
grâce = грас
grumpo = грампо
guardate = гуардате
h = х
hammerin = хэммерин
headache = хед­ейк
headaches = хед­ейкс
hél = хел
her = хёр
here’ll = хир’л
herself = хёрселф
ho = хо
humanoid = хью́маноид
i = ай
inattention = инаттеншен
intention = интеншен
into = инту
j = дж
k = к
klicks = кликс
knew = нью́
l = л
laserwriter = лейзеррайтер
laughin = лэфин
lep’s = леп’с
leprecon = лепрекон
lepretrieval = лепретри́вал
live = лайв
live1 = лайв
live2 = лив
lives = лайвз
lives1 = лайвз
lives2 = ливз
lope’s = лопе’с
lun’s = лун’с
lungful = лангфул
m = м
ma’am = мэм
magick = мэджик
magicks = мэджикс
maybe = мейби
meanin = ми́нин
minh = мин
minute = минит
minutes = минитс
moonometer = муно́метер
movin = му́вин
mr = мр
mrs = мрс
muchacho = мучачо
mulch = малч
multihinged = малтихинджд
multiphase = малтифейз
mummlp = маммлп
n = н
nguyen = нгуйен
nighty = найти
nonmagical = нонмэджикал
nsa = э́н-э́с-эй
nooo = ноооуу
o = о
of = ов
once = ўанс
onto = онту
oo = у́
outta = аутта
oww = ауу
owww = аууу
p = п
p’sh = п’ш
palmtop = палмтоп
pc = пк
perp = пёрп
perps = пёрпс
pentathol = пентаҫол
perfect = пёрфект
perfect1 = пёрфект
perfect2 = перфект
piggie = пигги
punctuating = панкчуейтинг
putting = путтинг
q = к
r = р
re = ре
read = ри́д
read1 = ри́д
read2 = ред
reading = ри́динг
rewind = реўайнд
rewinding = реўайндинг
rí = ри́
rimet = риме
ropy = роупи
roundabout = раунд­а­баут
s = с
sayonara = сайонара
says = сез
shao = шао
schiiick = шииик
schlippe = шлиппе
screwheads = скрью́хедз
scusatemi = скузатеми
semicongealed = семиконджи́лд
sensei = сенсей
skaylian = скейлиан
slimily = слаймили
smoothie = сму́ҙи
snakelike = снейк­лайк
sometimes = самтаймз
spookin = спу́кин
squawling = скўо́линг
stogies = стоугиз
succinylcholine = суксинилколин
superefficient = супер-э̀фишент
suplex = саплекс
suplexed = саплекст
t = т
tear1 = тир # слеза
tear2 = тер # рвать
telekinetic = телекайнетик
their = ҙейр
theirs = ҙейрз
they’re = ҙей’р
there’ll = ҙер’л
thirty = ҫёрти
thorough = ҫароу
to = ту
today = тудей
today’s = тудей’с
together = тугеҙер
tonight = тунайт
toward = тув̆орд
trubs = трабз
tutankhamen = тутанкамен
tutti = тут­ти
tv = тв
u = у
ufo = ю́́фоу
unarmored = анарморд
unbattered = анбэттерд
unblinking = анблинкинг
upholster = апхоулстер
upholstery = апхоулстри
upon = апон
use = ю́з
use1 = ю́с
use2 = ю́з
update = апдейт
updated = апдейтед
updates = апдейтс
updatng = апдейтинг
uv = ю́́-ви́
v = в
velcroed = велкрод
w = ў
warnin = ўорнин
wartface’s = ўортфейс’с
were = ўӭр
weren’t = ўӭрн’т
whatcha = ўотча
whatever = ўот­е­вер
withdraw = ўиҙдро́
withdraws = ўиҙдро́з
withdrawing = ўиҙдро́инг
withdrew = ўиҙдрю́
withdrawn = ўиҙдро́н
withdrawal = ўиҙдро́ал
withdrawals = ўиҙдро́алз
without = ўиҙ­аут
wraithlike = рейҫлайк
wrestlemania = реслмэниа
www = даблъю-даблъю-даблъю
x = кс
y = й
you’re = йо’р
your = йор
yours = йорз
z = з
’e = ’и́
’er = ’ӭр
’re = ’р
’s = ’с