# 0. á é í ó ô ú û ¬ ’

1870s = 1870es
a4 = a4
a = a
aaah = aaaa
aaahs = aaaaes
aahing = aaaing
aamons = aamons
aaron = áron
aaron’ll = áron’l
aaron’s = áron’s
abbit = abbit
abidden = abiden
abide = abaid
abided = abaided
abides = abaides
abiding = abaiding
abiding = abaiding
ablaze = ableiz
ablazed = ableized
abode = aboud
aboot = abôt
absentminded = absentmainded
absentmindedly = absentmaindedli
abuse1 = abús
abuse2 = abúz
abuse = abúz
abuses1 = abúses
abuses2 = abúzes
abuses = abúzes
abysmal = abizmal
abyssal = abisal
ac = ak
acc = akk
accentuated = akcentúáted
accentuating = akcentúáting
accidentally = akcidentalli
accounta = akaunta
ach = ach
ached = eiked
ache = eik
aches = eikes
achieve = achév
achieved = achéved
achievement = achévment
achievements = achévmentes
achille = ashil
achine = ashin
achinge = achinj
aching = eiking
achingly = eikingli
achoo = achô
acknowledge = aknolej
acknowledgment = aknolejment
acknowledgments = aknolejmentes
acorn = eikorn
acorns = eikornes
acquaintance = aqueintanc
acquaint = aqueint
acquainted = aqueinted
acquainting = aqueinting
acquaints = aqueintes
acquiesce = aquiesc
acquiesced = aquiesced
acquiesces = aquiesces
acquiescing = aquiescing
acquire = aquír
acquired = aquíred
acquires = aquíres
acquiring = aquíring
acquisition = aquizicion
acre = eiker # er/re
acres = eikeres # er/re
adds = ades
adored = adored
adrikon = adrikon
adrikon’s = adrikon’s
advert = advert
advertize = advertíz
advertized = advertízed
advertizes = advertízes
advertizing = advertízing
adverts = advertes
æ = æ
aelmon = aelmon
aff = aff
affair = afer
affairs = aferes
afher = afher
afire = afair
afrai = afrei
afterlife = afterlaif
afterwards = afterwordes
agape = ageip
agas = agas
agata = agata
ageless = ájless
aggrieve = agrév
aggrieved = agréved
aggrievedly = agrévedli
aggrieves = agrévz
aggrieving = agréving
agic = ajik
agician = ajicyan
agnes = agness
agnes’s = agness’s
ago = agou
agoin = agouin
agreeable = agréabel # el/le
agree = agré
agreed = agréed
agreeing = agréing
agreement = agrément
agreements = agrémentes
agrees = agrées
ah = aa
aheade = ahed
aida = aida
aidan = eidan
aidan’s = eidan’s
aimin = eimin
ain = ein
ain’t = ei’nt
’air = ’eir
air = eir
airing = eir
aisle = ayl
aisling = ashling
aislings = ashlinges
aisling’s = ashling’s
akamar = akamar
akamar’s = akamar’s
ake = eik
akhran = akhran
akhran’s = akhran’s
aladdin = aladin
aladdin’s = aladin’s
al = al
alamogordo = alamogordo
albedo = albédo
albrecht = albrekt
albus’s = albus’s
alecky = aleki
ale = eil
’alf = ’af
alfo = alfo
alfo = alfo
alicanté = alikante
align = alín
aligned = alíned
aligning = alíning
aligns = alínes
alike = alaik
alit = alit
alive = alaiv
alkyhol = alkihol
alkyholic = alkiholik
alle = ol
alleon = aleon
allergic = alerjik
allergy = alerji
alleys = alies
alloon = alôn
allop = alop
allows = alaues
all’s = ol’s
allus = alus
almost = olmoust
alone = aloun
alongside = alongsaid
alor = alor
alors = alores
alors = alors
alright = ol¬rayt
alternate = alternát
alternated = alternáted
alternates = alternátes
alternating = alternáting
alternative = alternativ
alternatively = alternativli
althoug = olthou
altogether = oltogether
alt’rin = olt’rin
alvays = olveies
always = olweies
alzzo = alzou
amateur = amatúr
amateurish = amatúrish
amateurs = amatúres
amaze = ameiz
amazed = ameized
amazedly = ameizedli
amazement = ameizment
amazes = ameizes
amazin = amázin
amazing = ameizing
amazingly = ameizingli
amazonas = amazonas
ambulance’ll = ambúlanc’l
amme = am
amourist = amûrist
amped = amped
amphitheater = amfithéater
amphitheaters = amfithéatres
amphitheatre = amfithéater
amphitheatres = amfithéatres
anacondas = anakondaes
analoggy = analoji
a’nangel = a’nangel
ana’s = ana’s
anathema’s = anathema’s
anforth = anforth
’ang = ’ang
anged = anged
angells = angels
angerous = anjeros
angles = angles
annonball = anonbol
annoying = anoing
anothere = anuther
ansaphone = ansafón
ansaphones = ansafónes
answer = anser
answered = ansered
answering = ansering
answers = anseres
antagonise = antagoníz
antagonised = antagonízed
antagonises = antagonízes
antagonising = antagonízing
antecorridor = antekoridor
antiseptic’s = antiseptik’s
antoine = antuan
antoine’s = antuan’s
anythin = anithin
anytime = enitaim
anywhar = aniwar
aphorisms = aforizmes
apiece = apyc
apologise = apolojíz
apparent = apárent
apparently = apárentli
appeal = apél
appealed = apéled
appealing = apéling
appeals = apéles
appearance = apéranc
appearances = apérances
appear = apér
appeared = apéred
appearing = apéring
appears = apéres
appease = apéz
appeased = apézed
appeases = apézes
appeasing = apézing
appened = apened
applied = aplaied # ai\b
applies = aplaies # ai\b
apply = aplai # ai\b
applying = aplaing # ai\b
appomattox = apomatox
appreciation = apréciátion
approche = apróch
aquarium = aquárium
araby = arabi
archaeologist = arkeolojist
archaeologists = arkeolojistes
ardilla = ardila
area = área
aren’t = ar’nt
arert = arert
arge = arj
argh = arr
arietinum = arietinum
arise = araiz
aristocracy = áristokraci
aristos = aristoes
arkansas = arkanso
armorer’s = armorer’s
armwaving = armweiving
armwavings = armweivinges
arose = arouz
aroun = araun
arpeggio = arpejio
arpeggios = arpejioes
arrogance = ároganc
arrogant = árogant
arrogantly = árogantli
’arrow = ’arou
arrow = arou
arrows = aroues
articles = artikles
arundel = arundel
asa = asa
asap = asap
’as = ’as
asa’s = ása
asa’s = asa’s
asa’s = ása’s
as = az
ascertain = acerten
ascertained = acertened
ascertaining = acertening
ascertains = acertenes
asenion = azénion
ashamed = asheimed
ash’s = ash’s
ashtoreth = ashtoreth
aside = asaid
asimov = azimov
asimov’s = azimov’s
’asn’t = ’az’nt
asn’t = az’nt
aspirin = aspirin
aspirins = aspirines
asshole = as-hól
assholes = as-hóles
asshole’s = as-hól’s
assign = asín
assigned = asíned
assigning = asíning
assignment = asínment
assignments = asínmentes
assigns = asínes
assuage = asuáj
assuaged = asuájed
assuages = asuájes
assuaging = asuájing
assume = asúm
assumed = asúmed
assumes = asúmes
assuming = asúming
assurance = ashúranc
assurances = ashúrances
assure = ashúr
assured = ashúred
assuredness = ashúredness
assures = ashúres
assuring = ashúring
asted = asted
astride = astraid
’at = ’at
atch = ach
ate = eit
atisfied = atisfaied
atlanteans = atlanteanes
atlantisan = atlantizan
atlantisans = atlantizanes
atlantisans’d = atlantizanes’d
’ats = ’ates
’at’s = ’at’s
attaché = atashe
attaché’s = atashe’s
attenborough = atenboro
atter = ater
attractions = atrakciones
atuous = atúos
audition = aúdicion
auditioning = aúdicioning
aunt = aúnt
aunts = aúntes
aunt’s = aúnt’s
aunty = aúnti
aunty’s = aúnti’s
aura = aúra
auras = aúraes
auschwitz = aushvits
authorities = aúthorities
authority = aúthoriti
ava = áva
avait = aveit
avarona = avarona
avarona’s = avarona’s
ava’s = áva’s
av = av
’aven’t = ’av’nt
aven’t = av’nt
avenues = avenúes
average = averaj
averages = averajes
aversion = averzion
avocados = avokadoes
awa = awe
awake = aweik
awaken = aweiken
awakened = aweikened
awakening = aweikening
awakens = aweikenes
aware = awer
awareness = awerness
awarenesses = awernesses
awed = ooed
aweing = ooing
awe = oo
awesome = oosum
awes = ooes
awfice = oofic
awfully = oofulli
awfulness = oofulness
awful = ooful
awhile = awail
awing = ooing
awkwardly = ookwordli
awkwardness = ookwordness
awkward = ookword
awning = ooning
awnings = ooninges
awoken = awouken
aw = oo
awresi = awresi
awry = orai
awww = oooo
ax = aks
axe = aks
axed = aksed
axes = akses
axing = aksing
aye = aay
ays = es
azerafel = azerafel
aziraphale = azirafál
aziraphale’s = azirafál’s
azrael = azrael
azure = azúr
azz = azz
baa = baa
baal = baal
baalite = baalít
baalites = baalítes
ba = ba
baba = baba
baba’s = baba’s
babe = beib
babes = beibes
babies = beibies
baby = beibi
babysat = beibisat
baby’s = beibi’s
babysitter = beibisiter
babysitters = beibisiteres
babysitting = beibisiting
bachs = bakes
backbone = bakboun
backbone’s = bakboun’s
backfire = bakfair
backfired = bakfaired
backfires = bakfaires
backfiring = bakfairing
backside = baksaid
backyard = bak¬yard
baddicombe = badikôm
bafflement = bafelment
bagnio = bagnio
bairn = bárn
bake = beik
baked = beiked
bakelite = bákelít
baker = beiker
bakers = beikeres
baker’s = beiker’s
baking = beiking
balain = balein
bald = bold
baldes = boldes
bale = bál
baleful = beilful
balefully = beilfulli
bales = báles
baley = beili
baleys = beilies
baley’s = beili’s
balistrariae = balistrarie
balls = boles
bananas = bananaes
bandoned = bandoned
bandsman’s = bandesman’s
banshees = banshyes
b’ar = b’ar
bare = beir
bared = beired
barefoot = beirfût
barely = beirli
bareness = beirness
barf = barf
bargain = bargen
bargained = bargened
bargainer  = bargener
bargainers  = bargeneres
bargaining = bargening
bargains = bargenes
barkbound = barkbaund
barracuda = barakûda
barracudas = barakûdaes
barred = bared
barrel = barel
barrels = barles
barring = baring
bartizan = bartizan
bastable = bastabel
bates = bátes
bathe = beith
bathed = beithed
bathes = beithes
bathing = beithing
battersea = batersy
battycakes = batikeikes
baubles = baúbles
bawl = bool
bawled = booled
bawling = booling
bawls = booles
bayonet = báyonet
bayous = baiôes
bazamm = bazam
b = b
bbc = bbk
beach = bych
beadle = bydel # el/le
beadles = bydles # el/le
beamis = bymis
beanie = béni
bear = ber
bearcat = berkat
beard = byrd
bearded = byrded
beards = byrdes
bearing = bering
bears = beres
beasley’s = bysli’s
beast = bést
beasts = béstes
beast’s = bést’s
beau = bó
beaujolais = bojole
beauregard = bóregard
beau’s = bó’s
beauteous = beuteos
beauties = beuties
beautiful = beutiful
beautifully = beutifulli
beauty = beuti
beautyrest = beutirest
be = by
became = bekeim
bedde = bed
bedroom = bed¬rôm
bedrooms = bed¬rômes
bedsheet = bed¬shyt
bedside = bedsaid
bedtime = bedtaim
bed’ve = bed’v
bee = bé
beeeeeeeeeeeee = byyyyyyyyyyyy
beef = béf
beefburger = béf¬burger
beefburgers = béf¬burgeres
beehive = béhaiv
beeline = bélín
beelzebub = bélzebub
been = byn
bees = bées
beetle = bytel # el/le
beetles = bytles # el/le
beetling = bytling # el/le
befallen = befolen
beguile = begíl
beguiled = begíled
beguiles = begíles
beguiling = begíling
behave = beheiv
behaved = beheived
behaves = beheives
behaving = beheiving
behavioral = beheivioral
behavior = beheivior
behaviorist = beheiviorist
behavioristic = beheivioristik
behaviormetric = beheiviormetrik
behaviour = beheivior
behin = behain
behind = behaind
behinde = behaind
behinds = behaindes
beijing = beijing
beijing’s = beijing’s
being = bying
beings = byinges
beirut = beirôt
belgium = beljium
bellboys = belboies
bellig = belij
belsize = belsaiz
be’n = be’n
benedictae = benedikte
benign = benín
bequest = bekwest
bequested = bekwested
bequesting = bekwesting
bequests = bekwestes
berkeley = berkli
berkshire = berk¬shir
bermuda = bermúda
bermudas = bermúdaes
berrizene = berizén
berserk = berserk
bes = bes
beside = besaid
besides = besaides
beta = beta
betamacks = betamakes
betrothal = be¬trouthal
betroth = betrouth
betrothed = betrouthed
betrothing = betrouthing
betroths = betrouthes
better = beter # er/re
bettered = betred # er/re
bettering = betring # er/re
better’n = beter’n
betters = betres # er/re
beverage = beveraj
beverages = beverajes
beware = bewer
beyond = be¬yond
bf1 = bf1
bibbette = bibet
bibbey = bibi
bibliophilic = bibliofilik
bichos = bichoes
bidets = bideies
biggun = bigun
biltonn = bilton
bind = baind
binders = bainderes
binding = bainding
bindings = baindinges
binns = bines
biopic = bíopik
biospatial = bíospácial
birch = berch
birches = berches
bird = berd
birdsall = berdzol
birds = berdes
bird’s = berd’s
birth = berth
birthday = berthdei
birthdays = berthdeies
birthplace = berthplác
birthplaces = berthpláces
biscuit = biskit
biscuits = biskites
bisexual = bísexúal
bite = bait
bites = baites
biting = baiting
bitingly = baitingli
bit’re = bit’r
bit’s = bit’s
bizarre = bizar
bizarrely = bizarli
bizarreness = bizarness
blabbin = blabin
blackbeard = blakbyrd
blackbeard’s = blakberd’s
blacke = blak
blacking = blaking
blackshirt = blak¬shert
blackshirts = blak¬shertes
blade = bleid
blades = bleides
blake = bleik
blakes = bleikes
blameless = blámless
blancmange = blanmonj
blankline = blank¬lín
blashter = blashter
blatvatatatsky = blatvatatatski
blaupunkt = blaupunkt
blaze = bleiz
blazed = bleized
blazer = bleizer
blazes = bleizes
blazing = bleizing
blessi = blesi
blimey = blaimi
blind = blaind
blinded = blainded
blindfold = blaindfold
blinding = blainding
blindly = blaindli
blinds = blaindes
bling = bling
blithely = blaithli
bloddy = blodi
bloggs = bloges
blondined = blondined
b’long = b’long
b’longs = b’longes
b’longs = b’longs
bloomin = blômin
blotch = bloch
blotched = bloched
blotches = bloches
blotching = bloching
blotterful = bloterful
blowethe = bloueth
blowin = blouin
bluebell = bleubel
blue = bleu
bluebottle = bleubotel # el/le
blueness = bleuness
blueprint = bleuprint
blueprints = bleuprintes
blues = bleues
blueshirt = bleu¬shert
blueshirts = bleu¬shertes
bluest = bleuest
bluetooth = bleutôth
bluey = blei
blumberg’s = blumberg’s
blur = blur
blurd = blerd
blurred = blured
blurring = bluring
blurs = blures
blurt = blert
blurted = blerted
blurting = blerting
blurts = blertes
boas = bóaes
bocks = bokes
bofe = bouf
boggarts = bogartes
boggarts = bogarts
boggs = boges
bogueloosa = bogelôza
bohacker = bohaker
boke = bouk
boko = boko
bokonon = bokonon
bokononism = bokononizm
bokononist = bokononist
bokononists = bokononistes
bokonon’s = bokonon’s
bold = bould
boligee = bolijé
bolívar = bolívar
bolivar’s = bolivar’s
bolt = bolt
bolted = bolted
bolts = boltes
bondsman = bondesman
bone = boun
boned = bouned
bones = bounes
bonfire = bon¬fair
bonfires = bon¬faires
bony = bouni
booger = bôger
booke = bûk
bool = bôl
boool = bôôl
bops = bopes
borasisi = borasisi
bore = bor
bored = bored
borel = borel
borough = burou
boroughs = buroues
bosch = bos
botham = boutham
both = bouth
botherin = botherin
bots = botes
bottle = botel # el/le
bottled = botled # el/le
bottlelike = botel¬laik # el/le
bottles = botles # el/le
bottling = botling # el/le
boughs = baues
bounce = bauns
bounced = baunsed
bounceless = baunsless
bounces = baunses
bouncing = baunsing
bow1 = bou # archer
bow2 = bau # bending
bow = bau
bowing1 = bouing # archer
bowing2 = bauing # bending
bowing = bauing # bending
bows1 = boues # archer
bows2 = baues # bending
bows = baues
box = boks
boxcar = bokskar
boxes = bokses
boxful = boksful
boxing = boksing
boyish = boish
boys = boies
bracelet = bráclet
bracelets = brácletes
brainwave = brein¬weiv
brainwaves = brein¬weives
brake = breik
brakes = breikes
brande = brand
brande = brand
brande’s = brand’s
brath = brath
braug = braúg
braug’s = braúg’s
brawl = brool
brawled = brooled
brawling = brooling
brawls = brooles
brazen = breizen
brazened = breizened
brazening = breizening
brazenly = breizenli
brazenness = breizenness
brazens = breizenes
brazier = breizier
braziers = breizieres
break = breik
breakfust = breik¬fust
breakingly = breikingli
breathily = brethili
breathtaking = brethteiking
brett = bret
brett’s = bret’s
brevier = brevier
brian = braian
brian’s = braian’s
bribe = bríb
bribed = bríbed
bribes = bríbes
bribing = bríbing
bride = braid
bridegroom = braidgrôm
bridegrooms = braidgrômes
bridle = braidel # el/le
bridles = braidles # el/le
bridling = braidling # el/le
brine = brain
bringeth = bringeth
bringin = bringin
britain = britan
brobdingnagians = brobdingnagianes
bro = brou
brogans = broganes
broke = brouk
broken = brouken
brokenhearted = broukenharted
brokenly = broukenli
broncel = broncel
brougham = brouam
broughams = brouames
brownshirt = braun¬shert
brownshirts = braun¬shertes
brows = braues
bruisable = brúzabel
bruise = brúz
bruised = brúzed
bruises = brúzes
bruising = brúzing
brung = brung
bryant = bríant
bt = bt
bubble = bubel # el/le
bubbled = bubled # el/le
bubbles = bubles # el/le
bubblin = bublin
bubbling = bubling # el/le
bubbly = bubli # el/le
buchenwald = bôkenvald
buckle = bukel # el/le
buckles = bukles # el/le
buggerall = bugerol
buggre = buger
bugle = búgel # el/le
bugles = búgles # el/le
buh = bu
buildings = bildinges
bukovero = bukovero
bulgaria = bulgária
bulwer = bulwer
bumin = bumin
bumwa = bumwa
bundle = bundel # el/le
bundles = bundles # el/le
bundling = bundling # el/le
bundt = bunt
bunsen = bunsen
buoy = boy
buoyed = boyed
buoying = boying
buoys = boyes
burchfield’s = burch¬fyld’s
burden = berden
burdened = berdened
bureau = búro
bureaucracy = búrokraci
bureaucrat = búrokrat
bureaucratic = búrokratik
bureaucrats = búrokrates
burl = berl # eCC
burmudez = burmudez
burn = bern
burned = berned
burnin = bernin
burning = berning
burns = bernes
burnt = bernt
burr = bur
burred = bured
burring = buring
burrow = burou
burrowed = buroued
burrowing = burouing
burrows = buroues
burrs = bures
burst = berst
bursting = bersting
bursts = berstes
burton = berton
business = bizness
businesslike = biznes¬laik
businessman = biznesman
businessmen = biznesmen
bustled = busled # el/le
busying = biziing
butterflies = buterflaies
buy = bay
buye = bay
buyed = bayed
buyer = bayer
buyers = bayeres
buyer’s = bayer’s
buyin = bayin
buying = baying
buys = bayes
bwuvver = bwuver
by = bai
bychance = baichanc
bye = bai
byes = baies
bygone = baigon
bygones = baigones
bypass = baipass
bypassed = baipassed
bypasses = baipasses
bypassing = baipassing
byrd’s = berd’s
bystander = baistander
bystanders = baistanderes
byways = baiweies
c6 = k6
caagneey = kaagnii
cabala = kabala
cabled = kábled # el/le
cable = kábel # el/le
cables = kábles # el/le
cabling = kábling # el/le
caedia = kaedia
caelenian = kaelenian
caelen = kaelen
caesar = cézar
caesar’s = cézar’s
café = kafe
cafés = kafees
caffeine = kaféin
cagney = kagni
cagney’s = kagni’s
cain = káin
cain’t = kei’nt
cair = kaar
ca = ka
cakebread’ve = keikbred’v
caked = keiked
cake = keik
cakes = keikes
caking = keiking
caliber = kaliber # er/re
calibers = kalibres # er/re
calibre = kaliber # er/re
calibres = kalibres # er/re
callback = kolbak
callbacks = kalbakes
callin = kolin
callousness = kalosness
came = keim
camelhair = kamelher
camila = kamila
campaign = kampein
campaigns = kampeines
campfire = kampfair
campfires = kampfaires
canapé = kanape
candle = kandel # el/le
candles = kandles # el/le
cangaroo = cangarô
cannonball = kanonbol
cannonballs = kanonboles
cannot = kannot
canterbury = kanterberi
can’t = ka’nt
canyon = kanion
canyons = kaniones
capa = kapa
capek’s = čapek’s
capon = kápon
capon’s = kápon’s
cappuccino = kapûchino
capsized = kapsaized
capsize = kapsaiz
capsizes = kapsaizes
capsizing = kapsaizing
captiva = kaptiva
capybaras = kapibaraes
caracci = karachi
carbs = karbes
cared = kered
careful = kerful
carefully = kerfulli
carefulness = kerfulness
caregiver = kergiver
caregiver = kergiver
caregivers = kergiveres
caregivers = kergiveres
care = ker
careless = kerless
carelessly = kerlesli
carelessness = kerlesness
cares = keres
caressing = karessing
caretaker = ker¬teiker
caretakers = ker¬teikeres
caribbean = karibéan
caribbeans = karibéanes
caring = kering
carlisle = karlail
caromed = karomed
carpe = karpe
carriage = kariaj
carriages = kariajes
carriageway = kariajwei
carrington = karington
carringtons = karingtones
carrycot = karikot
carryin = kariin
casinos⁠ = kasinoes⁠
casinos = kasinoes
cassettes = kasetes
castels = kastles
castle = kasel # el/le
castles = kasles # el/le
catalogued = kataloged
cataplana = kataplana
catc = catc
catechism = katekizm
caterham = keiteram
catholic = katholik
catsy = katsi
caught = koot
cauldron’s = kaúldron’s
’cause = ’kuz
cavaliers = kavalires
cawed = kooed
cawfee = koofé
cawing = kooing
caw = koo
caws = kooes
cayman = káiman
caymans = káimanes
caz = kaz
c = c
ccc = ckk
cc = kk
ccp = ckp
ccp’s = ckp’s
cd = kd
cd = kd
cds = kdes
ceana = ceana
cease = cés
ceased = césed
ceases = céses
ceasing = césing
ceddie = cedi
cedric = cedrik
cedric’s = cedrik’s
cellmate = celmeit
center = center # er/re
centers = centres # er/re
centi = centi
centre = center # er/re
centres = centres # er/re
centreville = center¬vil
ceos = ceoes
’cept = ’cept
’ceptin = ’ceptin
’cepting = ’cepting
cereal = céreal
cereals = céreales
cerebric = cerebrik
cerebro = cerebro
ceri = ceri
ceri’s = ceri’s
certain = certen
certaine = certen
certainly = certenli
cf = cf
cg = cg
chain = chán
chained = cháned
chaining = cháning
chainmail = chán¬meil
chainsaw = chánsoo
chainsaws = chánsooes
chains = chánes
chair = cher
chairs = cheres
chair’s = cher’s
chalk = chook
chalks = chookes
champagne = shampán
champagnes = shampánes
changeling = chánjling
changelings = chánjlinges
charred = chared
chase = chác
chased = cháced
chases = cháces
chasin = chácin
chasing = chácing
chaste = chást
chastely = cheistli
chattels = chatles
chaw = choo
ch = ch
cheat = chét
cheated = chéted
cheating = chéting
cheats = chétes
cheekbone = chyk¬boun
cheekboned = chyk¬bouned
cheekbones = chyk¬bounes
chérie = chérie
cherries = cheries
cherry = cheri
cherubims = cherubimes
chesty = chesti
chewalla = chewala
chew = cheu
chews = cheues
chickenlike = chikenlaik
chide = chaid
chided = chaided
chides = chaides
chiding = chaiding
chief = chéf
chiefer = chéfer
chiefest = chéfest
chiefly = chéfli
chiefs = chéfes
chief’s = chéf’s
childbirth = chaildberth
child = chaild
childhood = chaild¬hûd
childish = chaildish
childishly = chaildishli
childless = chaildless
children = child¬ren
childs = chaildes
child’s = chaild’s
chile = chail
chile = chile
chillun = chilun
chilterns = chilternes
chime = chaim
chimed = chaimed
chimes = chaimes
chiming = chaiming
chimings = chaiminges
chinaberry = chínaberi
chinese = chínéz
chisel = chizel
chiseled = chizled
chiseling = chizling
chiselled = chizled
chiselling = chizling
chisels = chizles
chitter = chiter
chittered = chitered
chittering = chitering
chitterred = chitered
chitterring = chitering
chitters = chiteres
chocobanana = chokobanana
chocolat = chokolat
chocolate = chokolat
chocolates = chokolates
chocolaty = chokolati
choirgirl = kuairgerl
choir = kuair
choke = chouk
choked = chouked
choker = chouker
chokes = choukes
choking = chouking
chokingly = choukingli
choky = chouki
chopin = shopen
chose = chouz
chosen = chouzen
christianity = kristianiti
christian = kristian
christmas = krismas
christmastime = krismastaim
chuckle = chukel # el/le
chuckled = chukled # el/le
chuckles = chukles # el/le
chuckling = chukling # el/le
chummily = chumili
church = cherch
churches = cherches
churchie = cherchi
churchie’s = cherchi’s
churl = cherl # eCC
churn = chern
churned = cherned
churning = cherning
churns = chernes
cia = cia
ciao = chao
cicled = cirkled
cieren = cieren
cigarettes = cigaretes
cindi = cindi
cindi’s = cindi’s
cio = kio
circlet = cirklet
circlets = cirkletes
circumstantial = cirkum¬stancial
civism = civizm
clackclackclack = klakklakklak
claimed = klámed
claiming = kláming
claim = klám
claims = klámes
clarksonland = klarksonland
classificisioned = klasifikicizioned
classmate = klas¬meit
classmates = klas¬meites
clawed = klooed
claw = kloo
cleared = kléred
clearer = klérer
cleares = kléres
clearest = klérest
clearing = kléring
clear = klér
clearly = klérli
cleavage = klyvaj
cleedy = klydi
cleef = klyf
clene = klyn
cleo’s = kléo’s
clerkenwell = klerkenwel
clerk = klerk
clerks = klerkes
clerk’s = klerk’s
cliché = klishei
climaxed = klímaxed
climaxes = klímaxes
climaxing = klímaxing
climax = klímax
climbed = klaimed
climbing = klaiming
climb = klaim
climbs = klaimes
clit = klit
clockwise = klokwaiz
clockwork = klokwerk
clo’es = klo’es
clomp = klomp
clopping = kloping
close1 = klous
close2 = klouz
closed = klouzed
close = klous
closely = klousli
closeness = klousness
closer = klouser
closes = klouzes
closest = klousest
closing = klouzing
clothed = klouthed
clothe = klouth
clothes = klouthes
clothing = klouthing
clousarr = klousar
cloven = klouven
clueless = klúless
clues = klúes
clumsily = klumzili
clumsy = klumzi
clyde = klaid
c’mon = kumon
co2 = co2
coarse = kours
coarser = kourser
coaster = kóster
coast = kóst
coatis = koaties
coaxed = kouksed
coaxes = koukses
coaxing = kouksing
coaxingly = kouksingli
coax = kouks
cobblestones = kobel¬stounes
cochineal = kochinéal
cockatrice = kokatric
cockatrices = kokatrices
cockerel = kokerel
cockerels = kokerles
cocksure = kokshúr
coffee = kofé
coffee’s = kofé’s
coiffeur = kuafur
co = ko
colin’s = kólin’s
collapsed = kolapsed
collapseing = kolapsing
collapse = kolaps
collapses = kolapses
collarbone = kolar¬boun
collarbones = kolar¬bounes
collared = kolared
colleague = colég
colleague = kolég
colleagues = coléges
colleagues = koléges
collyridians = koliridianes
cologne = kolón
colonel = kurnel
colonels = kurneles
colonel’s = kurnel’s
colorless = kulorless
colourless = kulorless
colt = koult
colts = koultes
columns = kolumes
combed = koumed
combing = kouming
comb = koum
combs = koumes
comedie = komedi
comin = kumin
commandeer = komandér
commandeers = komandéres
commercial = komercial
committee = komité
committees = komitées
communo = komúno
companionable = kompanionabel # el/le
compared = kompáred
compare = kompár
complained = kompláned
complaining = kompláning
complainin = kompleinin
complain = komplán
complains = komplánes
complexion = komplexion
complexions = komplexiones
comte = cont
concealed = koncéled
concealing = koncéling
conceal = koncél
concealled = koncéled
concealment = koncélment
concealments = koncélmentes
conceals = koncéles
concerned = koncerned
concerning = koncerning
concern = koncern
concerns = koncernes
concordia = konkordia
concordian = konkordian
concorsa = konkorsa
conduit = kondúit
confeescated = konféskáted
confess = konfess
confirmate = konfirmát
confirmed = konfirmed
confirming = konfirming
confirm = konfirm
confirms = konfirmes
congealed = kon¬jéled
congealing = kon¬jéling
congeal = kon¬jél
congeals = kon¬jéles
congrats = kongrates
conjurer = konjurer
conjurers = konjureres
conjurer’s = konjurer’s
connersville = koneresvil
conscience = konscienc
conscientious = konsciencios
conscientiously = konscienciosli
constitutionally = konstitútionalli
consul = konsul
consuls = konsules
consul’s = konsul’s
continong = kontinong
continues = kontinúes
converged = konverjed
converge = konverj
converges = konverjes
converging = konverjing
conveyances = konveyances
conveying = konveing
conveys = konveies
co’pons = kopones
cop’s = kop’s
copyright = kopirayt
’cordin = ’kordin
cornellians = kornelians
cornell = kornel
cornells = korneles
cornshuck = kornshuk
corpse = korps
corpses = korpses
corrected = korekted
correcting = korekting
correct = korekt
correct = korekt
correctly = korektli
corrects = korektes
corridor = koridor
corroded = koróded
corrode = koród
corrodes = koródes
corroding = koróding
corrosion = korózion
corrupted = korupted
corrupting = korupting
corruption = korupcion
corruptions = korupciones
corrupt = korupt
corrupts = koruptes
cosmetic = kozmetik
cosmetokit = kozmetokit
cosy = kouzi
cotch = koch
cotswolds = koteswoldes
coughed = kofed
coughing = kofing
cough = kof
coughs = kofes
coulda = kûda
coulder = kûder
could = kûd
couldn’t = kûd’nt
counterclockwise = kaunterklokwaiz
counterspy = kaunterspai # ai\b
countrier = kauntrier
countryside = kuntrisaid
coupla = kupla
courage = kuraj
courageous = kurajos
course = kors
courses = korses
’cours = ’kors
courthouse = kort-haus
courtin = kortin
courtyard = kort¬yard
cove = kouv
coveralls = kuveroles
coverless = kuverless
coves = kouves
cowarde = kauard
cowboys = kauboies
cowlley = kauli
cows = kaues
coyote = koyóte
cozied = kouzied
cozily = kozili
cozy = kouzi
crackjaws = krakjooes
crackle = krakel # el/le
crackles = krakles # el/le
crackling = krakling # el/le
cracow = krakou
cradled = kreidled # el/le
cradle = kreidel # el/le
cradles = kreidles # el/le
cranby = kranbi
craned = kreined
crane = krein
cranes = kreines
craning = kreining
crate = kreit
crates = kreites
cratz = krats
craved = kreived
crave = kreiv
craves = kreives
craving = kreiving
craw = kroo
crawled = krooled
crawlee = krooli
crawlies = kroolies
crawling = krooling
crawl = krool
crawls = krooles
crawly = krooli
crayon = kreion
crayons = kreiones
crazed = kreized
craze = kreiz
crazier = kreizier
craziest = kreiziest
crazy = kreizi
creamiest = krémiest
cream = krém
creams = krémes
cream’s = krém’s
creamy = krémi
creased = krésed
crease = krés
creases = kréses
creasing = krésing
created = kreáted
create = kreát
creates = kreátes
creating = kreáting
creation = kreácion
creative = kreátiv
creator = kreátor
creators = kreátores
creature = kréatúr
creatures = kréatúres
creature’s = kréatúr’s
credential = kredencial
credentials = kredenciales
creepily = krypili
crème = krem
cremorne = kremorn
crenels = krenles
crews = kreues
cried = kraied
cries = kraies
crimewatch = krímwoch
cripple = kripel # el/le
cripples = kriples # el/le
crippling = kripling # el/le
critically = kritikli # kli
cr = kr
croissant = kruasant
crosby = krozbi
crosbys = krozbies
crosby’s = krozbi’s
crossword = kroswerd
crosswords = kroswerdes
crowy = kroui
crowzley = krouzli
crrrrk = krrrrk
crueler = krúeler
crueller = krúeler
cruelty = krúelti
crumbs = krumes
crumpled = krumpled
crumptious = krumpcios
crying = kraing
cryin = krain
cry = krai
cryme = krím
csm = ksm
ct = kt
cuddle = kudel # el/le
cuddles = kudles # el/le
cuddling = kudling # el/le
culpepper’s = kulpeper’s
cumulus = kúmulus
cunnin = kunin
cupboard = kupbord
cupier = kúpier
curacara = kurakara
curled = kerled # eCC
curling = kerling # eCC
curl = kerl # eCC
curls = kerles # eCC
currencies = kurencies
currency = kurenci
current = kurent
currents = kurentes
cursed = kersed
curse = kers
curses = kerses
cursing = kersing
curtained = kurtened
curtain = kurten
curtains = kurtenes
curtseying = kurtsiing
curtseys = kurtsies
curvier = kurvier
cutie = kúti
cypripedium = cipripedium
czech = chekh
czechoslovakia = chekhoslovakia
dadblamed = dad¬bleimed
dadblammit = dad¬blamit
dad’d = dad’d
daddy’ll = dadi’l
daddywaddykins = dadiwadikines
daemonspawn = démonspaún
daggle = dagel # el/le
daguerreotype = dagerotíp
daguerreotypes = dagerotípes
dah = daa
dahs = das
daie = dei
daleland = deilland
damian = dámian
damian’s = dámian’s
damn = damn
damned = damned
dampness = dampness
dancin = dancin
dane = dein
daneel = danyl
daneel’s = danyl’s
danes = deines
danged = danged
danish = deinish
dared = dered
dare = der
daren’t = der’nt
daresay = der¬sei
dares = deres
dares = ders
daring = dering
darkness’s = dark¬ness’s
darksome = darksum
dawdled = doodled # el/le
dawdle = doodel # el/le
dawdles = doodles # el/le
dawdling = doodling # el/le
dawg = doog
dawn = doon
dawned = dooned
dawning = dooning
dawns = doones
daybreak = dei¬breik
days = deies
daytime = dei¬taim
daze = dáz
dazed = dázed
dazes = dázes
dazing = dázing
dazzle = dazel # el/le
dazzles = dazles # el/le
dazzling = dazling # el/le
dbtb = dbtb
dc = dk
d = d
deacantian = deakancian
deacon = dékon
deacons = dékones
deactivated = deaktiváted
deactivate = deaktivát
deactivates = deaktivátes
deactivating = deaktiváting
deactivation = deaktivácion
dealin = dylin
dealin’s = dylin’s
dear = dir
dearie = diri
dearly = dirli
deathe = deth
debauch = debaúch
debauchery = debaúcheri
debetur = debetur
debrief = debréf
début = debú
deceased = decésed
decease = decés
deceases = decéses
deceasing = decésing
deceivin = decévin
decepticonattacker = deceptikonataker
declared = dekláred
declare = deklár
declares = dekláres
declaring = dekláring
declassification = deklasifikácion
declassifications = deklasifikáciones
decomposed = dekompózed
decompose = dekompóz
decompose = dekompóze
decomposes = dekompózes
decomposing = dekompózing
decreased = dekrésed
decrease = dekrés
decreases = dekréses
decreasing = dekrésing
decreasingly = dekrésingli
de = de
de’el = de’el
deer = dyr
deer’s = dyr’s
defalcation = defalkácion
defalcations = defalkáciones
defeat = defét
defeated = deféted
defeating = deféting
defeats = defétes
defect1 = défekt
defect2 = defekt
defects1 = défektes
defects1 = défekts
defects2 = defektes
defects2 = defekts
defence = defens
defense = defens
defrost = defrost
defrosted = defrosted
defrosting = defrosting
defrosts = defrostes
defyin = defain
degree = degré
degrees = degrées
de’il = de’il
deirdre = dyrdre
deirdre’s = dyrdre’s
deisenburger = daizenburger
deisenburger’s = daizenburger’s
delight = delít
delighted = delíted
delightful = delítful
delightfully = delítfulli
delighting = delíting
delights = delítes
delphine = delfyn
delt = delt
deltoids = deltoides
demdyke = demdaik
demeanor = deménor
demeanour = deménor
demopolis = demopolis
denied = denaied # ai\b
denies = denaies # ai\b
denig = denig
denig’s = denig’s
deny = denai # ai\b
denying = denaing # ai\b
derbies = derbies
dere = der
des = des
dese = dyz
design = dezín
designed = dezíned
designer = dezíner
designers = dezíneres
designing = dezíning
designs = dezínes
désirée = désirée
dé­si­rée = dezire
despair = desper
despaired = despered
despairing = despering
despairs = desperes
desperate = desperat
despiser’s = despízer’s
destrian = destrian
destroying = destroing
deter = deterr
determination = determinácion
determined = determined
determine = determin
determines = determines
determining = determining
deterred = deterred
deterring = deterring
deters = deterres
detestation = detestátion
detour = detûr
detoured = detûred
detouring = detûring
detours = detûres
deviated = deviáted
deviate = deviát
deviates = deviátes
deviating = deviáting
devil’d = devil’d
devilment = devil¬ment
devissey = devisi
dew = deu
dewing = deu¬ing
deztiny = deztini
df = df
diagonally = díagonalli
diamagnetic = díamagnetik
diamine = diamín
diamond = díamond
diamonds = díamondes
diaper = díaper
diceman = dícman
diddled = didled # el/le
diddle = didel # el/le
diddles = didles # el/le
diddling = didling # el/le
did’n = did’n
didn = didn
didn’t = did’nt
die = dai
died = daied
diego = diego
dies = daies
dieu = dieu
differently = diferentli
differunt = diferunt
diggety = digeti
dildos = dildoes
dime = dím
dimness = dimness
dimple = dimpel # el/le
dimples = dimples # el/le
dimpling = dimpling # el/le
dimwitted = dimwited
dine = dín
dingle = dingel # el/le
dingles = dingles # el/le
dingy = dinji
dining = díning
dinna = dina
dinnertime = dinertaim
dinni = dini
dinosaurs = dínosaúres
direckly = direkli
directions = direkciones
direful = dair¬ful
dirndl = dirndel
dirt = dert # eCC
dirtied = dertied # eCC
dirty = derti # eCC
disagreed = disagréed
disagree = disagré
disagreeing = disagréing
disagreement = disagrément
disagrees = disagrées
disappearance = disapéranc
disappearances = disapérances
disappear = disapér
disappeared = disapéred
disappears = disapéres
discern = discern
discerned = discerned
discernible = discernibel
discerning = discerning
discerns = discernes
disconcert = diskoncert
disconcerted = diskoncerted
disconcerting = diskoncerting
disconcerts = diskoncertes
discorporated = diskorporáted
discos = diskoes
discouverie = diskuveri
discreet = diskrét
discreetly = diskrétli
diseased = dizézed
disease = dizéz
diseases = dizézes
disgustin = disgustin
dishabilly = dishabili
dishevel = dishevel
disheveled = disheveled
disheveling = disheveling
dishevels = disheveles
disliked = dislaiked
dislike = dislaik
dislikes = dislaikes
disliking = dislaiking
dismissively = dismisivli
disod = disod
disoy = disoi
dissociated = disóciáted
dissociate = disóciát
dissociates = disóciátes
dissociating = disóciáting
distaste = disteist
distastefully = disteistfulli
distinguish = distinguish
distinguished = distinguished
distinguishes = distinguishes
distinguishing = distinguishing
dit = dit
dits = dites
diuerse = divers
dive = daiv
dived = daived
diver = daiver
divers = daiveres
diver’s = daiver’s
diversion = diverzion
diversions = diverziones
divert = divert
diverted = diverted
diverting = diverting
diverts = divertes
dives = daives
divideth = divídeth
divinatory = divinátori
diving = daiving
dna = dna
doasey = douzi
do = dô
doe = dou
does = dus
doesn’t = dus’nt
dogbreaths = dogbrethes
dogend = dogend
doggonit = dogonit
dog’ll = dog’l
dogness = dogness
dogshit = dogshit
doin = dôin
doled = douled
dole = doul
doles = doules
domingus = domingus
domingus’s = domingus’s
domo = domo
donged = donged
donjuán = donhuan
don’t = dou’nt
doodley = dôdli
doomsday = dômesday
door = dor
doorframe = dor¬freim
doorframes = dor¬freimes
doorknob = dornob
doors = dores
doorways = dorweies
dopier = doupier
dos = does
dotings = dotinges
doubled = dubled # el/le
double = dubel # el/le
doubles = dubles
doubly = dubli # el/le
doubtful = dautful
doubtfully = dautfulli
douchebags = dôshbages
dour = dúr
dourly = dúrli
dove2 = douv
dowling’s = dauling’s
downright = daunrayt
downsize = daunsaiz
downsized = daunsaized
downsizes = daunsaizes
downsizing = daunsaizing
downst = daunst
downsy = daunsi
downtime = dauntaim
dozed = douzed
doze = douz
dozes = douzes
dozing = douzing
draggle = dragel # el/le
draggles = dragles # el/le
draggling = dragling # el/le
dragonkin = dragon¬kin
drakul = drakûl
dramedy = dramedi
drap = drap
draped = dráped
drape = dráp
drapes = drápes
draping = dráping
drawback = droo¬bak
draw = droo
drawer = drooer
drawers = drooeres
drawers = drooers
draweth = drooeth
drawing = drooing
drawings = drooinges
drawl = drool
drawled = drooled
drawling = drooling
drawls = drooled
drawn = droon
dr = dr
dreamtime = drymtaim
drearily = dririli
dress = dress
dressed = dressed
dresses = dresses
dressing = dressing
dribble = dribel # el/le
dribbles = dribles # el/le
dribbling = dribling # el/le
dried = draied
drily = draily
drive = draiv
driver = draiver
drivers = draiveres
driver’s = draiver’s
drives = draives
driveway = draivwei
driveways = draivweies
drivin = draivin
driving = draiving
drizzle = drizel # el/le
drizzles = drizles # el/le
drizzling = drizling # el/le
droll = dról
droned = drouned
drone = droun
drones = drounes
droning = drouning
dropcloth = dropkloth
dropcloths = dropklothes
drove = drouv
drown’ding = draun’ding
dryer = draier
dryers = draieres
dryly = draili
duality = dúaliti
dubble = dubel # el/le
duco = duko
duffle = dufel
duffles = dufles
dugway = dugwei
dulcibelle = dulcibel
dulcibelle’s = dulcibel’s
dulcitude = dulcitúd
dune = dún
dungeon = dunjon
dungeons = dunjones
dunno = dunnou
dunraven = dunreiven
dunravens = dunreivenes
dunroamin = dunroumin
dunt = dunt
duprass = dupras
dupree = dûpré
during = dúring
durrell = durel
duskford = dusk¬ford
dvd = dvd
d’ya = d’ya
dye = day
dyed = dayed
dyer = dayer
d’yer = d’yer
dyers = dayeres
dyer’s = dayer’s
dyes = dayes
dyewood = day¬wôd
dying = daing
dyot = diot
d’you = d’yô
eadache = edeik
’ead = ’ed
eando = eando
’eard = ’erd
eared = ired
earing = iring
ear = ir
earldom = erldom # eCC
earl = erl # eCC
earlier = erlier # eCC
earliest = erliest # eCC
earlobe = ir¬loub
earlobes = ir¬loubes
earls = erles # eCC
early = erli # eCC
earned = erned
earn = ern
earnest = ernest
earnestly = ernestli
earnestness = ernestness
earning = erning
earnings = erninges
earns = ernes
ears = ires
’eart = ’art
eartfelt = artfelt
earthed = erthed # eCC
earth = erth # eCC
earthing = erthing # eCC
earthly = erthli
earthman = erth¬man # eCC
earthman’s = erth¬man’s # eCC
earthmen = erth¬men # eCC
earthmen’s = erth¬men’s # eCC
earthquake = erth¬kweik # eCC
earthquakes = erth¬kweikes # eCC
earths = erthes # eCC
earth’s = erth’s # eCC
earthshattering = erth¬shatering
earthy = erthi # eCC
’ear = ’yr
eased = ézed
ease = éz
easier = ézier
easiest = éziest
easily = ézili
easy = ézi
eateth = yteth
eatin = ytin
eau = ó
eautiful = útiful
eavesdropped = yvesdroped
eavesdropped = yvs¬droped
eavesdropping = yvesdroping
eavesdropping = yvs¬droping
eavesdrops = yvesdropes
eavesdrops = yvs¬dropes
eavesdrop = yvesdrop
eavesdrop = yvs¬drop
’eavy = ’evi
ebook = ebûk
ech = ech
ecipe = ecipe
eclair = ekler
eclairs = ekleres
ecluded = eklúded
economically = ekonomikli # kli
ecret = ékret
edgewise = ejwaiz
edifyin = edifain
e = e
eec = eek
eee = yyy
eetle = étel # el/le
eez = yz
ef’n = ef’n
eggs = eges
eighteen = eyttyn
eighteenth = eyttynth
eight = eyt
eighth = eytth
eighths = eytthes
eightieth = eyttith
eighty = eytti
eigh’y = ey’i
einsteinian = ainstainian
either = yther
elba = elba
electroencephalograph = elektroencefalograf
electroencephalographic = elektroencefalografik
electroencephalographs = elektroencefalografes
elicious = élicios
elijah = elíja
elixir’s = elixir’s
ellerete = eleret
elliots = eliotes
’e’ll = ’y’l
eloquentiae = elokuentiae
’elp = ’elp
elp = elp
else = els
elzebub = elzebub
emarkably = emarkabli
embarrassed = embarased
embarrass = embaras
embarrasses = embarases
embarrassing = embarasing
embarrassingly = embarasingli
embarrassment = embarasment
emerald = emerald
emerged = emerjed
emerge = emerj
emergencies = emerjencies
emergency = emerjenci
emerges = emerjes
emerging = emerjing
emile = emyl
’em’ll = ’em’l
emoji = emóji
employee = employé
employees = employées
emptily = emptili
ence = enc
enclosed = enklouzed
encouraged = enkurajed
encourage = enkuraj
encourages = enkurajes
encouraging = enkurajing
endeared = endired
endear = endir
endearing = endiring
endears = endires
endin = endin
endinge = ending
endless = end¬less
endureth = endúreth
eneimies = enemies
’en = ’en
en = en
enerally = enerali
engendered = enjendred
engender = enjender
engendering = enjendring
engenders = enjendres
engineered = enjinéred
engineer = enjinér
engineering = enjinéring
engineers = enjinéres
enjoyin = enjoin
enjoying = enjoing
enjoys = enjoyes
ennywone = eniwun
ensemble = ansambel
ensign = ensin
ensigns = ensines
entered = entred # er/re
enter = enter # er/re
entering = entring # er/re
enters = entres # er/re
enthusiasm = enthúziazm
enthusiastically = enthúziastikli
enthusiastic = enthúziastik
entire = entír
entirely = entírli
entranceway = entrancwei
entreated = entréted
entreat = entrét
entreating = entréting
entreats = entrétes
enviroment = envíroment
envoys = envoies
ep = ep
erased = erázed
erase = eráz
erases = erázes
erasing = erázing
eration = erácion
’ere = ’ir
’er = ’er
’ere’s = ’ir’s
eriod = ériod
erious = érios
errible = eribel # el/le
errrrrrrrrr = errrrrrrrrr
errrrrrrrrrwhaeeeeeeeee = errrrrrrrrrwayyyyyyyyy
errrukh = errruh
ertain = ertein
erupted = erupted
erupt = erupt
erupting = erupting
erupts = eruptes
eschewed = escheued
eschew = escheu
eschewing = escheuing
eschews = escheues
es = es
eskimo = eskimo
eskimos = eskimoes
esp = esp
esq = esq
essential = esencial
essentials = esenciales
estaurant = estaúran
est = est
’e’s = ’y’z
etamorphosis = etamorfosis
etc = etc
eternal = eternal
eternally = eternalli
eternity = eterniti
ethereal = ethéreal
etheric = etherik
european = européan
europeans = européanes
eutaw = eutoo
eva = éva
evenings = yvninges
evening’s = yvning’s
evening = yvning
evenin = yvnin
evenly = yvenli
evenness = yvenness
even = yven
everglade = evergleid
everglades = evergleides
evergreen = evergryn
evergreens = evergrynes
ever’thing = ever’thing
ever’whar = ever’war
everydayness = evrideiness
every = evri
everythin = evrithin
everytime = evritaim
e’ve = y’v
eve = yv
evil = yvil
evitable = evitabel # el/le
ewes = yôes
ewe = yô
exceeded = excéded
exceed = excéd
exceeding = excéding
’exceedingly = ’excédingli
exceedingly = excédingli
exceeds = excédes
exclaimed = exklámed
exclaim = exklám
exclaiming = exkláming
exclaims = exklámes
excuse1 = exkús
excuse2 = exkúz
excuses1 = exkúses
excuses2 = exkúzes
exertion = exercion
exertion = exercion
exertions = exerciones
expense = expens
expenses = expenses
explained = expláned
explain = explán
explaining = expláning
explains = explánes
expressways = expressweies
extry = ekstri
exuberant = exúberant
exuded = exúded
exude = exúd
exudes = exúdes
exuding = exúding
’e = ’y
eye = ay
eyeball = ay¬bol
eyeballs = ay¬boles
eyebrow = ay¬brau
eyebrows = ay¬braues
eyed = ayed
eyeing = aying
eyelashe = ay¬lash
eyelashes = ay¬lashes
eyeless = ayless
eyelessly = aylesli
eyelid = ay¬lid
eyelids = ay¬lides
eyeliner = ay¬líner
eyepiece = ay¬pyc
eyes = ayes
eyeshadow = ayshadoues
eyeshadowed = ayshadoued
eyesight = ay¬sait
fabritek = fabritek
faceless = fácless
fack = fak
fadeaway = feid¬awei
faded = feided
fade = feid
fades = feides
fading = feiding
fahrenheit = farenhait
failin = feilin
fair = feir
fairly = feirli
fair’s = feir’s
faithful = feithful
faithfulness = feithfulness
faked = feiked
fake = feik
faker = feiker
fakers = feikeres
fakes = feikes
faking = feiking
falcon = folkon
falcons = folkones
falcon’s = folkon’s
fallen = folen
falling = foling
false = fols
falsehood = fols-hûd
falsehoods = fols-hûdes
falsify = folsifai # ai\b
fam = fam
fam’ly = fam’li
fane = fein
fanes = feines
fantastically = fantastikli # kli
fare = fer
fares = feres
farewelled = ferweled
farewell = fer¬wel
farewell = ferwel
farewelling = ferweling
farewells = ferweles
fa’r = fa’r
farmin = farmin
fashionable = facionabel # el/le
fashioned = facioned
fashion = facion
fashions = faciones
faste = fast
fastened = fasened
fasten = fasen
fastening = fasening
fastens = fasenes
fastolfe = fastolf
fatly = fatli
fawn1 = faún # young deer
fawn2 = foon # exhibit affection
fawned2 = fooned
fawned = fooned
fawning2 = fooning
fawning = fooning
fawns1 = faúnes # young deer
fawns2 = foones # exhibit affection
fazed = feized
faze = feiz
fazes = feizes
fazing = feizing
fbi = fbi
fear = fir
fearfully = fir¬fulli
fearlessness = firlesness
fears = fires
feasted = fésted
feast = fést
feasting = fésting
feasts = féstes
feats = fétes
featured = fétúred
feature = fétúr
featureless = fétúrless
features = fétúres
featuring = fétúring
fees = fyes
fe = fe
feigned = feyned
feign = feyn
feigning = feyning
feigns = feynes
félicité = felicite
fellen = felen
female = fémál
ferenc = ferents
ferenc’s = ferents’s
ferrari = ferari
fettle = fetel # el/le
fettles = fetles # el/le
fettling = fetling # el/le
f = f
ff = ff
ffolkes = ffoukes
fiancé = fiance
fiber = fíber # er/re
fibers = fíberes # er/re
fibre = fíber # er/re
fibres = fíbres # er/re
fida = fida
fiddled = fidled # el/le
fiddle = fidel # el/le
fiddles = fidles # el/le
fiddling = fidling # el/le
fierce = férc
fiercely = fércli
fiercely = fércli
fierceness = fércness
fiercer = fércer
fiercest = fércest
fiery = fairi
figger = figer
fightin = faitin
fighty = faiti
fild = fild
file1 = fíl # computer data; collection of papers; column of people
file2 = fail # tool
filed2 = failed
filed = fíled
file = fíl
files2 = failes # tool
files = fíles
filiae = filiae
filigree = filigré
filigrees = filigrées
filing = fíling
filter = filter # er/re
filters = filtres # er/re
filtre = filter # er/re
filtres = filtres # er/re
fimbriata = fimbriata
finally = fínalli
finchley = finchli
finder = fainder
finder’s = fainder’s
find = faind
findin = faindin
finding = fainding
finds = faindes
finem = finem
fings = finges
finn = finn
finn’s = finn’s
fireball = fairbol
firebox = fairboks
firebreathing = fairbrything
firecracker = fairkraker
firecrackers = fairkrakeres
fired = faired
firedrake = fair¬dreik
firedrakes = fair¬dreikes
fire = fair
fireflies = fairflaies
firefly = fairflai
firelighter = fair¬laiter
firelighters = fair¬laiteres
firelight = fair¬lait
firelock = fairlok
firelocks = fairlokes
fireman = fairman
firemen = fairmen
fireplace = fairplác
fireplaces = fairpláces
fireproof = fairprôf
fires = faires
fireside = fairsaid
firetrap = fair¬trap
firewood = fairwôd
firework = fair¬werk
firework = fair¬wurk
fireworks = fair¬werkes
fireworks = fair¬wurkes
firing = fairing
firm1 = firm # noun
firm2 = ferm # adj
firmament = firmament
firmer = fermer
firm = ferm
firmly = fermli
firms = firmes
first = ferst # eCC
firstly = ferstli # eCC
fishin = fishin
fived = faived
five = faiv
fixin = fiksin
flagstone = flagstoun
flagstones = flagstounes
flaked = fleiked
flake = fleik
flakes = fleikes
flaking = fleiking
flared = flered
flare = fler
flares = fleres
flarin = flerin
flaring = flering
flashlights = flashlaites
flaughter = flooter
flawed = flooed
flaw = floo
flawless = flooless
flawlessly = floolesli
flaws = flooes
flaxened = flaksened
flaxen = flaksen
flaxening = flaksening
flaxens = flaksenes
flax = flaks
flayme = fleim
flea = flé
fleas = flées
fleece = flys
fleeces = flyses
flee = fly
fleeing = flying
flees = flyes
fleshily = fleshili
flex = flex
flibberty = fliberti
flies = flaies
flirtatious = flertácios
flirted = flerted # eCC
flirt = flert # eCC
flirtier = flertier # eCC
flirting = flerting # eCC
flirts = flertes # eCC
flirty = flerti # eCC
flivver = fliver
floodin = fludin
floors = flores
floorwalker = florwooker
floorwalkers = florwookeres
florence = florenc
flow = fló
floyd = floid
floyd’s = floid’s
fluffernutter = flufernuter
fluffernutters = flufernuteres
fluorescence = fluorescenc
flurry = fluri
flyer = flaier
flyers = flaieres
flyer’s = flaier’s
fly = flai
flyin = flain
flying = flaing
flyover = flai¬ouver
flyovers = flai¬ouveres
fo = fo
fogett = foget
folds = foldes
folk = fouk
folklore = fouk¬lor
folks = foukes
folks’ll = foukes’l
folkways = foukweies
follows = foloues
foma = foma
fooled = fôled
foole = fôl
fool = fôl
foolin = fôlin
foolish = fôlish
fools = fôles
foothill = fût-hil
foothills = fût-hiles
footwear = fût¬weir
forbade = forbeid
foredeck = fordek
’fore = ’for
foreglance = forglans
foregoes = forgoues
forego = forgou
foregoing = forgouing
foregone = forgon
foreignness = forenness
forelock = forlok
forever = for¬ever
forewent = forwent
foreword = forwerd
fo’r = fo’r
forgave = forgeiv
formally = formalli
forn = forn
forsake = forseik
forsaken = forseiken
forsaking = forseiking
forty = fourti
forwards = forwordes
fo’ty = fo’ti
foulard = fôlard
foun = faun
four = four
fours = foures
fourteen = four¬tyn
fourth = fourth
foxed = foksed
foxes = fokses
fox = foks
foxglove = foksgluv
foxhole = foks-hól
foxholes = foks-hóles
foxier = foksier
fox’s = foks’s
foxy = foksi
frae = frei
’fraid = ’freid
framed = freimed
frame = freim
frames = freimes
framework = freim¬werk
frameworks = freim¬werkes
framing = freiming
framley = framli
framleys = framlies
framley’s = framli’s
franca = franka
frank’a = frank’a
frankenstein = frankenstein
frasten = frasten
fraternal = fraternal
fraternally = fraternalli
fraternities = fraternities
fraternity = fraterniti
freckled = frekled # el/le
freckle = frekel # el/le
freckles = frekles # el/le
frederick = frederik
freed = fryed
freemantle = frymantel
freemantles = frymantles
freer = fryer
frens = frenes
friday = fraidei
fridays = fraideies
fried = fraied
friendliness = frendliness
frien = fren
frights = fraites
frilly = frilli
fro = frou
from = from
frostbite = frost¬bait
froze = frouz
frozen = frouzen
frozenly = frouzenli
fruitcake = frút¬keik
fruitcakes = frút¬keikes
fryars = fríares
ft = ft
fuckable = fukabel
fuckster = fukster
fugging = fuging
fuh = fu
fulla = fûla
fully = fûlli
fulvarum = fulvarum
fumbled = fumbled # el/le
fumble = fumbel # el/le
fumbles = fumbles # el/le
fumbling = fumbling # el/le
fundamentally = fundamentalli
funty = funti
furl = ferl # eCC
furnitur = furnitúr
furo = furo
furo’s = furo’s
furred = fured
furrier = furier
furriers = furieres
furrier’s = furier’s
furrowed = furoued
furrow = furou
furrowing = furouing
furrows = furoues
fwancis = fwancis
fwizzpt = fwizpt
fyres = faires
fysher = físher
fyshers = físhers
gable = gábel # el/le
gables = gábles # el/le
gabriel2 = gabriel
gadith = gadith
gaiman = geiman
gaing = geing
galadriel = galadriel
galaxatrons = galaxatrones
gale = geil
gamaliel = gamaliel
gamble = gambel # el/le
gambles = gambles # el/le
gambling = gambling # el/le
gamboled = gamboled
gamed = geimed
game = geim
gamer = geimer
gamers = geimeres
games = geimes
gaming = geiming
gaol = jeil
gaped = geiped
gape = geip
gapes = geipes
gaping = geiping
garish = gerish
gate = geit
gatehouse = geit-haus
gatekeeper = geit¬kyper
gatepost = geit¬póst
gateposts = geit¬póstes
gates = geites
gates’s = geites’s
gateway = geit¬wei
gave = geiv
gaveston = gaveston
gawd = good
gawked = gooked
gawk = gook
gawking = gooking
gawks = gookes
gawky = gooki
gazed = geized
gaze = geiz
gazes = geizes
gazing = geizing
gears = gires
gearstick = girstik
geed = jéed
geed = jyed
geeing = jying
gee = jé
gees = jyes
geiger = gaiger
geigers = gaigeres
geladria = geladria
gelatly = gelatli
ge’mun = je’mun
generally = jeneralli
genetically = jenetikli # kli
genre = janer
genres = janeres
gentelmann = jentelman
gentle = jentel # el/le
gentleman’s = jentelman’s # el/le
geodetic = jéodetik
george = jorj
georgia = jorjia
gerbil = jerbil
gerrigel = gerigel
gerrrronnnimooooo = jerrrronnnimooooo
getcha = gecha
gettin = getin
gettsyburg = getsiberg
g = g
ghost = goust
ghostly = goustli
ghosts = goustes
gibberty = giberti
gidreshnap = gidreshnap
giggled = gigled # el/le
giggle = gigel # el/le
giggles = gigles # el/le
giggling = gigling # el/le
gillid = gilid
giocondo = jokondo
giraffes = jirafes
girder = gerder
girders = gerderes
girdle = gurdel # el/le
girdles = gurdles # el/le
girdling = gurdling # el/le
girlfriend = gerldewfrend
girlfriend = gerlfrend
girlfriends = gerldewfrendes
girl = gerl # eCC
girlish = gerlish # eCC
girls = gerles # eCC
girl’s = gerl’s # eCC
girly = gerli
gis = gis
git = git
gits = gites
gits = gits
gittin = gitin
g’lactic = g’laktik
glade = gleid
glades = gleides
glaim = gleim
glair = gleir
glanceable = glansabel
glanced = glansed
glance = glans
glances = glanses
glancing = glansing
glared = glered
glare = gler
glares = gleres
glaring = glering
glasgow = glasgou
glastonberry = glastonberi
glastonberry’s = glastonberi’s
glazed = gleized
glaze = gleiz
glazes = gleizes
glazing = gleizing
glided = glaided
glide = glaid
glides = glaides
gliding = glaiding
gliff = glif
glowin = glouin
glowworm = glou¬werm
glowworms = glou¬wermes
glubbing = glubing
glued = gleued
glue = gleu
glueing = gleuing
glues = gleues
gluing = gleuing
glup = glup
glyndbourne = glaindborn
gobby = gobi
godse = godse
goes = goues
goeth = goueth
go = gou
going = gouing
goin = gouin
goings = gouinges
goiter = goiter # er/re
goiters = goitres # er/re
goitre = goiter # er/re
goitres = goitres # er/re
golddust = golddust
goldsborough = goldesboro
goldsborough’s = goldesboro’s
golds = goldes
gonzales = gonzalec
goober = gôber
goodbye = gûdbai
goodbyes = gûdbaies
goodley = gûdli
goodleys = gûdlies
googled = gôgled # el/le
google = gôgel # el/le
googles = gôgles # el/le
googling = gôgling # el/le
goolsby’s = gôlesbi’s
goot = gôt
gorer = gorer
gorgeous = gorjeos
gorillas = gorilaes
gotter = goter
goverment = guverment
goverments = guvermentes
govermint = guvermint
graduate = gradúat
grandchild = grandchaild
granddaddy = granddadi
granddaughter = granddooter
grandma = grandma
grandmama = grandmama
grandparent = grand¬párent
grandparents = grand¬párentes
grandson = grandsunn
grandsons = grandsunnes
granfallooner = granfalôner
granfalloonery = granfalôneri
granfalloon = granfalôn
granfalloons = granfalônes
grapple = grapel # el/le
grapples = graples # el/le
grappling = grapling # el/le
grasshopper = gras-hoper
grasshoppers = gras-hoperes
grave = greiv
gravely = greivli
graves = greives
graves’s = greives’s
gravestone = greivstoun
gravestones = greivstounes
graveyard = greivyard
gravlax = gravlax
gravy = greivi
grayish = greish
grazed = greized
graze = greiz
grazes = greizes
grazing = greizing
greasy’s = grysi’s
greece = gréc
greek = grék
greeks = grékes
greenies = grynies
greenwich = grenich
grew = greu
greying = greing
grievance = grévanc
grievances = grévances
grimeadow = grimeadou
grimeadow’s = grimeadou’s
grimed = graimed
grime = graim
grimes = graimes
griming = graiming
grimy = graimi
grinded = grainded
grinder = grainder
grinders = grainderes
grindery = grainderi
grind = graind
grinding = grainding
grinds = graindes
grivet = grive
grocer = gróser
groceries = gróseries
grocers = gróseres
grocery = gróseri
groped = grouped
grope = group
gropes = groupes
groping = grouping
groping = grouping
gropingly = groupingli
groundwork = graund¬werk
grove = grouv
groves = grouves
growin = grouin
growly = grouli
grownup = groun¬up
grownups = groun¬upes
growt = grout
growt’s = grout’s
grrr = grrr
grubbian = grubian
grubbily = grubili
gruesome = grôsum
grumley = grumli
gt = gt
guaranteed = gárantéed
guarantee = gáranté
guarantees = gárantées
guardedness = gardedness
guavas = guavaes
gud = gud
guelder = gelder
guessed = gessed
guess = gess
guessing = gessing
guh = gu
guideline = gídlín
guinea = gini
guineas = ginies
guitar = gitar
guitars = gitares
gunk = gunk
gunwale = gunel
gurgled = gurgled # el/le
gurgle = gergel
gurgle = gurgel # el/le
gurgles = gergles
gurgles = gergles
gurgles = gurgles # el/le
gurgling = gergling
gurgling = gurgling # el/le
gurkha = gurka
gurkhas = gurkaes
guy = gai
guy = gí
guys = gaies
guy’s = gai’s
guys = gíes
gwound = gwaund
gynaecologist = gínekolojist
gynecologist = gínekolojist
gyoso = giozo
gyrdl = gyrdl
hachard = hachard
hachettebookgroup = hachetbûkgrôp
hackney = hakni
hackneys = haknies
hadn’t = had’nt
hae = há
haggled = hagled # el/le
haggle = hagel # el/le
haggles = hagles # el/le
haggling = hagling # el/le
hahnet = hanet
hahnet’s = hanet’s
hailed = heyled
hail = heyl
hailing = heyling
hails = heyles
hairbrush = herbrush
haircut = her¬kut
haircuts = her¬kutes
hairdresser = her¬dresser
hairdressers = her¬dresseres
haired = hered
hair = her
hairline = herlín
hair’ll = her’l
hairpiece = her¬pyc
hairpin = herpin
hairpins = herpines
hairs = heres
hair’s = her’s
hairshirt = her¬shert
hairshirts = her¬shertes
hairstyle = herstíl
haiti = háiti
hale = heil
haleyville = heilivil
halifax = halifaks
hallelujah = halelûya
hallo = halou
halls = holes
halstead = halsted
halsteads = halstedes
halstead’s = halsted’s
haltmann = haltman
haltmanns = haltmanes
hammerin = hamerin
handbeaten = handbyten
hande = hand
handful = handful
handfuls = handfules
handkerchief = hankerchif
handkerchiefs = hankerchifes
handkerchieves = hankerchives
handled = handled # el/le
handle = handel # el/le
handles = handles # el/le
handling = handling # el/le
handshaked = hand¬sheiked
handshake = hand¬sheik
handshakes = hand¬sheikes
handshaking = hand¬sheiking
handsomer = han¬sumer
handsomest = han¬sumest
handwriting = hand¬raiting
hangin = hangin
hankie = hanki
hankinses = hankinses
ha’penny = heipeni
harebrained = heirbreined
hare = heir
harriet = hariet
harrison = harisun
harrowed = haroued
harrow = harou
harrowing = harouing
harrows = haroues
harry = hari
harry’s = hari’s
has = has
hasn’t = has’nt
hastar = hastar
haste = heist
hastened = heisened
hastened = heistened
hasten = heisen
hasten = heisten
hastening = heisening
hastening = heistening
hasteningly = heiseningli
hasteningly = heisteningli
hastens = heisenes
hastens = heistenes
hastily = heistili
hastur = hastur
hastur’s = hastur’s
hasty = heisti
hatban = hatban
hatchel = hachel # el/le
hatchelling = hachling # el/le
hatchels = hachles # el/le
hated = heited
hated = heited
hateful = heitful
hateful = heitful
hate = heit
hater = heiter
haters = heiteres
hates = heites
hating = heiting
hatred = heitred
hattiesburg = hatisburg
haughtily = hootili
hauled = hooled
haul = hool
hauling = hooling
haulin = hoolin
hauls = hooles
haunt = haúnt
haunt’s = haúnt’s
hauteur = ótur
haven = heiven
havens = heivenes
haven’t = hav’nt
havin = havin
hawgs = hooges
hawing = hooing
hawked = hooked
hawk = hook
hawking = hooking
hawks = hookes
hawthorn = hoothorn
hawtrey = haútri
hawtrey’s = haútri’s
hayley’s = heilei’s
hayneville = heinvil
haze = heiz
hazel = heizel
hazel’s = heizel’s
haziness = heiziness
hazlitt = hazlit
hazlitt’s = hazlit’s
hazy = heizi
hazz = haz
hazzt = hazt
headache = hed¬eik
headaches = hed¬eikes
headdresses = heddresses
headdress = heddress
headstone = hedstoun
headstones = hedstounes
heah = hia
heah’ll = hia’ll
heah’s = hia’s
healed = héled
heal = hél
healing = héling
heals = héles
heard = hurd # eCC # to distinguish from 'herd'
’hear = ’hyr
hear = hyr
hearing = hyring
hearselike = herslaik
hears = hyres
heartache = harteik
heartaches = harteikes
heartbreak = hartbreik
heartbreaking = hartbreiking
heartbreakingly = hartbreikingli
heartbreaks = hartbreikes
heartbroke = hartbrouk
heartbroken = hartbrouken
hearthstone = harthstoun
hearthstones = harthstounes
hedd = hed
he’d = hy’d
heeeeee = hiiiiii
heel = hyl
heered = hyred
hef’s = hef’s
heftes = heftes
he = hy
heightened = haytened
heighten = hayten
heightening = haytening
heightens = haytenes
height = hayt
heights = haytes
heired = ered
heir = er
heiress = eress
heiresses = eresses
heirs = eres
heirs = eres
heisenberg = haizenberg
hellfire = hel¬fair
hellhound = helhaund
he’ll = hy’l
hello = helou
hellos = heloues
’hem = ’hem
henceforth = hens¬forth
hence = hens
he’p = he’p
he’pin = he’pin
he’ps = he’pes
herbal = herbal
herb = herb
herbs = herbes
herded = herded
herd = herd
herding = herding
herds = herdes
here = hir
herein = hir-in
here’s = hir’s
herewith = hirwith
her = hur
hermione = hermíone
hernez = hernez
herrup = herrup
herself = hur¬self
hers = hures
he’s = hy’s
hessick = hesik
heterosexual = heterosexúal
he’ve = hy’v
h = h
h’ = h’
hiccup = hikup
hiccups = hikupes
hic = hik
hide = haid
hideout = haid¬aut
hideouts = haid¬autes
hides = haides
hiding = haiding
hie = hai
hieronymus = hieronimus
hif = hif
highballed = hayboled
highball = haybol
highballing = hayboling
highballs = hayboles
highborn = hay¬born
highboy = hayboi
higher = hayer
highest = hayest
highhanded = hayhanded
high = hay
highlighted = haylaited
highlight = haylait
highlighting = haylaiting
highlights = haylaites
highly = hayli
highness = hayness
highs = hayes
highway = haywei
highwayman = hay¬wei¬man
highwaymen = hay¬wei¬men
hi = hai
hiked = haiked
hike = haik
hikes = haikes
hiking = haiking
hillside = hilsaid
himble = himbel # el/le
himme = him
himona = himona
hind = haind
hindquarters = haind¬quorteres
hindsight = haind¬sait
hinky = hinki
hipster = hipster
hipsters = hipsteres
hirāni = hirani
hired = haired
hire = hair
hires = haires
hiring = hairing
hirl = herl
his = hiz
hisself = hizself
hithe = haith
hive = haiv
hives = haives
hm = hm
hmm = hmm
hmmm = hmm
hmph = hmf
hmp = hmp
hms = hms
hoarding = hording
hoardings = hordinges
hoarse = hours
hoecake = houkeik
hoecakes = houkeikes
hoed = houed
hoenikker = honiker
hoenikkers = honikeres
hoenikker’s = honiker’s
ho = hou
holdin = holdin
holds = holdes
hole = hól
holey = houli
holidaymakers = holideimeikeres
hollywood = holiwôd
holstein = hol¬stain
holstered = houlstred
holster = houlster
holster = houlster
holstering = houlstring
holsters = houlstres
holy = houli
homebodies = houmbodies
home = houm
homeless = houmless
homeliness = houmliness
homely = houmli
homemade = houm¬meid
homeroom = houmrôm
homes = houmes
homesick = houmsik
homework = houmwerk
homosexual = hómosexúal
honed = houned
hone = houn
hones = hounes
honeybunch = hunibunch
honikker = honiker
honing = houning
honory = onori
hoode = hûd
hoofikins = hôfikines
hoofywoofies = hôfiwôfies
hooner = hôner
hoor = hôr
hoped = houped
hopeful = houpful
hopefully = houp¬ful¬li
hopefuls = houpfules
hope = houp
hopeless = houpless
hopelessly = houplesli
hopelessness = houplesness
hopes = houpes
hoping = houping
hopin = houpin
horriferous = horiferos
horrifically = horifikli
horse = hors
horsepersons = horspersones
horseplay = hors¬plei
horses = horses
horse’s = hors’s
horsie = horesi
horsie = horsi
horsin = horsin
hortense = hortens
hortense’s = hortens’s
hose = houz
hosepipe = houz¬paip
hosepipes = houz¬paipes
hoses = houzes
hould = hould
houngan = haungan
houn = haun
hounslow = haunes¬lou
hour = auer
hours = aueres
hour’s = auer’s
house2 = hauz
housebreaker = hausbreiker
housebreakers = hausbreikeres
houseflies = hausflaies
housefly = hausflai
household = haus-hold
household = haus-hould
households = haus-houldes
houseplant = hausplant
houseplants = hausplantes
houses2 = hauzes
house’ve = haus’v
housewife = hauswaif
housewife’s = haus¬waif’s
housewives = hauswaives
houston = heuston
hovel = huvel # el/le
hovelling = huveling # el/le
hovels = huveles # el/le
howed = houed
how’ll = hau’l
hows = haues
how’s = hau’s
hq = hq
huawei = huawei
hubei = hubei
huddles = hudles
hued = heued
hue = heu
hues = heues
huey = heui
huge = húj
hught = hûht
hught’s = hûht’s
hugos = húgoes
hullo = hulou
humanoid = húmanoid
hummm = hummm
hummmm = hummmm
humorless = húmorless
humorlessly = húmorlesli
humpf = humpf
humphed = humfed
humph = humf
humphing = humfing
hundret = hundret
hunnerd = hunerd
hunnert = hunert
huntresses = huntresses
huntress = huntress
huntress’s = huntress’s
hupehensis = hupehensis
hup = hup
hurled = herled # eCC
hurl = herl # eCC
hurling = herling # eCC
hurls = herles # eCC
hurrah = huraa
hurrahs = huraaes
hurricane = hurikán
hurricanes = hurikánes
hurried = huried
hurriedly = huriedli
hurries = huries
hurry = huri
hurrying = huriing
hurt = hert # eCC
hurting = herting # eCC
hurtled = hertled
hurtle = hertel
hurtles = hertles
hurtling = hertling
hurts = hertes # eCC
husband = husband
husbandry = huzbandri
husbands = husbandes
husband’s = husband’s
hustled = husled # el/le
hustle = husel # el/le
hustler = husler # el/le
hustlers = husleres # el/le
hustles = husles # el/le
hustling = husling # el/le
huuff = huuff
hygiene = híjien
hygienically = híjienikli # kli
hygienic = híjienik
hygienics = híjienikes
hygienist = híjienist
hymn = himm
hymns = himmes
hyposliver = hiposliver
hys = hiz
i1 = i
i = ai
iamond = íamond
ian’s = ian’s
ibbses = ibeses
ibbs = ibes
ibbs’s = ibes’s
iberville = ibervil
ice = ais
icebox = aisboks
icecream = aiskrym
iced = aised
iceman = aisman
icemen = aismen
icily = aisili
icing = aising
ick = ik
ictionary = ikcyonari
icy = aisi
i’d = ai’d
ida’s = ída’s
ideal = ídéal
idealistic = ídéalistic
idealist = ídéalist
idealists = ídéalistes
ideally = ídéalli
ideals = ídéales
identified = ídentifaied # ai\b
identifies = ídentifaies # ai\b
identify = ídentifai # ai\b
identifying = ídentifaing # ai\b
ideous = ídeos
idiculous = idikúlos
idiota = idiota
idle = aidel # el/le
idled = aidled # el/le
idleness = aidelness
idler = aidler
idles = aidles # el/le
idling = aidling # el/le
idly = aidli
iercing = yrcing
ight = ait
ignatius = ignácius
ignored = ignored
ii = ii
iii = iii
ik = ik
i’ll = ai’l
’ill = ’il
illuminati = ilúminati
i’m = ai’m
’im = ’im
imogene = imojen
imogene’s = imojen’s
impassible = impasibel
impasto = impasto
implied = implaied # ai\b
implies = implaies # ai\b
imply = implai # ai\b
implying = implaing # ai\b
imposs = impos
impulse = impuls
inarticulacy = inartikúlaci
incorrect = inkorekt
incorruptible = inkoruptibel
increased = inkrésed
increase = inkrés
increases = inkréses
increasing = inkrésing
increasingly = inkrésingli
indeed = indyd
indoors = indores
ineffectually = inefektúalli
in’erested = in’erested
infernal = infernal
infernally = infernalli
inferno = inferno
ing = ing
ingoing = ingouing
inhabitable = inhabitabel # el/le
inlaid = inleied
inne = in
innercent = inercent
inn = inn
innkeeper = inn¬kyper
innkeepers = inn¬kyperes
inns = inns
insanely = insánli
inside = insaid
insider = insaider
insiders = insaideres
insides = insaides
insight = insait
insofar = in¬sou¬far
instinctual = instinktúal
insurance = inshúranc
insurge = insurj
intake = inteik
intakes = inteikes
intense = intens
intention = intencion
intentions = intenciones
interbattalion = interbatalion
interested = interested
interesting = interesting
interestin = interestin
interest = interest
interests = interestes
interned = interned
interning = interning
intern = intern
interns = internes
interpretation = interpretácion
interregional = interréjional
interrupted = interupted
interrupting = interupting
interrupt = interupt
interruption = interupcion
interrupts = interuptes
interruptus = interuptus
intertwinement = interwainment
interviewed = interveued
interviewer = interveuer
interviewers = interveueres
interviewing = interveuing
interview = interveu
interviews = interveues
into = into
int’restin = int’restin
intrigued = intriged
intriguing = intriging
intriguingly = intrigingli
intrinsicate = intrinsikát
introverted = introverted
introvert = introvert
invadin = invádin
ion’s = yon’s
iowa = aiowa
ipad = ipad
ipa = ipa
ipple = ipel # el/le
ippo’s = ipo’s
ircle = irkel # el/le
ird = urd
’ire = ’air
ireland  = airland
irish = airish
irl = url
irm = urm
iron = aiern
ironbound = ai¬ern¬baund
ironclad = aiernklad
ironed = aierned
ironing = aierning
irons = aiernes
iron’s = aiern’s
ironwood = aiern¬wôd
irreg = ireg
irrelevant = irelevant
irrelevantly = irelevantli
irresistible = irezistibel # el/le
irresolute = irezolút
irreversibly = ireversibli
irritable = iritabel # el/le
irritably = iritabli # el/le
irritation = iritácion
irror = iror
irst = urst
isaac = ízak
isbell = isbel
isbells = isbeles
isbn = isbn
’is = ’iz
island = ailand
islander = ailander
islanders = ailanderes
islands = ailandes
island’s = ailand’s
isle = ail
isn’t = is’nt
israeli = izráeli
israel = izráel
issed = ised
italo = ítalo
ithuanian = ithuánian
ithyphallic = ithifalik
it’s = it’s
its = its
itte = it
ittes = its
itt = it
ittle = itel # el/le
ity = iti
ivanhoe = aivanhou
i’ve = ai’v
ivies = aivies
iv = iv
ivy = aivi
ix = ix
izz = iz
jacopo = jakopo
jacuzzis = jakûzies
jaime = haime
jaime’s = haime’s
jaipur = jaipûr
ja = ja
jamaica = jamáika
janry = janri
japura = japura
jarred = jared
jarring = jaring
jawed = jooed
jaw = joo
jawline = joolín
jaws = jooes
jean = jéan
jeans = jynes
jehoshaphat = jehoshafat
jemmied = jemied
jeopardy = jepardi
jerked = jerked
jerking = jerking
jerk = jerk
jerks = jerkes
jersey = jurzi
jes = jes
jess = jess
jess’s = jess’s
jews = jeues
jeyes = jeies
jezebel = jezebel
jezreel = jezryl
jiechi = jiechi
jigaboo = jigabô
jinping = jinping
j = j
joggled = jogled # el/le
joggle = jogel # el/le
joggles = jogles # el/le
joggling = jogling # el/le
johnsonites = jonsonites
johnstone = jonston
jokes = jókes
jolliness = joliness
jolted = joulted
jolting = joulting
jolt = joult
jolts = joultes
joshua = joshua
jostled = josled # el/le
jostle = josel # el/le
jostles = josles # el/le
jostling = josling # el/le
jouncing = jauncing
joys = joies
jpg = jpg
jr = jr
juan = huan
juanita = huanita
judgéd = jujed
judgmental = jujmental
judgment = jujment
judgments = jujmentes
judgy = juji
juggernaut = jugernoot
juggernauts = jugernootes
jugglers = jugleres
juh = ju
juice = júc
juices = júces
juicy = júci
julius = július
july = júlai # ai\b
junior = júnior
jupiter = júpiter
jurisdiction = júrisdikcion
jus = jus
jy = jai
kaffee = kafé
kaisa = kaisa
kaisa’s = kaisa’s
kali = kali
kangaroos = kangarôes
kaounda = kaûnda
kappamaki = kapamaki
karass = karas
katmandu = katmandû
keanu = keanû
keanu’s = keanû’s
keepsake = kypseik
ke = ke
kellerhals = kelerhales
keminsky = keminski
keminskys = keminskies
kep = kep
keratofiber = keratofíber
kernel = kernel
kernels = kerneles
kettle = ketel # el/le
kettles = ketles # el/le
kev = kev
kev’s = kev’s
keyboard = kybord
key = ky
keys = kyes
kgb = kgb
kibosh = kaibosh
kiddo = kido
kiena = kiena
kiena’s = kiena’s
kiflin = kiflin
kiki’s = kiki’s
kimonos = kimónoes
kinda = kainda
kinder = kainder
kindest = kaindest
kind = kaind
kindlin = kindlin
kindly = kaindli
kindness = kaind¬ness
kinds = kaindes
’kin’ell = ’kin’el
kirk = kerk
kirks = kerkes
kissable = kisabel
kite = kait
kites = kaites
kiul = kiûl
kiver = kiver
k = k
klatsch = klach
klemin = klemin
klippes = klippes
kneading = knyding
knead = knyd
knee = ny
knees = nyes
knew = kneu
knife = naif
knifish = nifish
knighthood = knait-hûd
knight = knait
knights = knaites
knives = naives
knobbesticke = nobestik
knoe = knou
kno = kno
knot = knot
knots = knotes
knowable = knouabel
knowing = knouing
knowin = knouin
know = knou
knowledgeable = knolejabel
knowledge = knolej
known = knoun
knows = knoues
knuckled = nukled # el/le
knuckle = nukel # el/le
knuckles = nukles # el/le
knuckling = nukling # el/le
knurl = nerl # eCC
kodaly = kodal
koenigs = konigs
koenigswald = konigswald
kookamundi = kôkamundi
krebbs = krebes
krebbs’s = krebes’s
kretyeen = kretyén
krystal’s = kristal’s
kuh = ku
kumari = kumari
kumbolaland = kumbolaland
kumu = kumu
ky = kai
labeled = lábled # el/le
labeling = lábling # el/le
label = lábel # el/le
labelled = lábled # el/le
labelling = lábling # el/le
labels = lábles # el/le
labour = lábor
laciniata = laciniata
laded = leided
lade = leid
laden = leiden
lades = leides
ladies = leidies
lading = leiding
ladled = leidled # el/le
ladle = leidel # el/le
ladles = leidles # el/le
ladling = leidling # el/le
lads’ll = lades’l
lady = leidi
ladylike = leidilaik
lady’ll = leidi’l
ladyship = leidiship
lady’s = leidi’s
laid = leied
laike = laík
lake = leik
lakes = leikes
lame = leim
lamely = leimli
lampshade = lampsheid
lampshades = lampsheides
lana’s = lana’s
lancashire = lankashir
landscape = landskeip
landscapes = landskeipes
landseer = landsir
lane = lein
lanes = leines
langlie = langli
language = languaj
languages = languajes
languished = languished
languishes = languishes
languishing = languishing
languish = languish
laserdisc = lázerdisk
late = leit
lately = leitli
later = leiter
latest = leitest
laughs = lafes
laundry = laúndri
lauren = loren
lauren’s = loren’s
lavaliere = lavalier
lawdamighty = loodamaiti
lawd = lood
lawful = looful
law’ll = loo’l
law = loo
lawman = looman
lawsey = loozi
laws = looes
law’s = loo’s
lawsuit = loosút
lawsuits = loosútes
lawsy = loozi
lawyer = looyer
lawyers = looyeres
lawyer’s = looyer’s
layin = lein
laze = leiz
lazily = leizili
laziness = leiziness
lazy = leizi
lead1 = led
lead = lyd
leads1 = ledes
league = lég
leagues = léges
leakin = lykin
leaned = lyned
leant = lent
leant = lynt
leapwood = lypwôd
learned = lerned # eCC
learner = lerner # eCC
learners = lerneres # eCC
learning = lerning # eCC
learnin = lernin # eCC
learnin = lirnin
learn = lern # eCC
learns = lernes # eCC
learnt = lernt # eCC
leastways = lystweies
leavened = levened
leavening = levening
leaven = leven
leavens = levenes
leavin = lyvin
leesa = lysa
leetle = lytel # el/le
legion = léjion
legions = léjiones
leisure = lézúr
leisurely = lézúrli
lemongrass = lemongras
lengths = lengthes
lensed = lenzed
lenses = lenzes
lensing = lenzing
lens = lenz
leonardo = léonardo
leone = leone
leroy = léroi
leroy’s = léroi’s
lesbian = lesbian
lesbians = lesbianes
le’s = le’s
lesly = lesli
less = less
less’n = les’n
lette = let
letterbox = leterboks
leveled = leveled # el/le
levelheadedness = levelhededness
leveling = leveling # el/le
levelled = leveled # el/le
level = level # el/le
levelling = leveling # el/le
levelly = levelli
levels = leveles # el/le
leventhorp = leven¬thorp
’lewis = ’leuis
liar = laier
liars = laieres
liberator = liberátor
liberators = liberátores
liberties = liberties
lice = lais
licken = liken
lidded = lided
liechtenstein = liktenstain
lied = laied
lie = lai
lies = laies
lifebelt = laif¬belt
lifebelts = lai¬fbeltes
lifeboat = laifbout
lifeboats = laifboutes
lifeguard = laifgard
life = laif
lifeless = laif¬less
lifelessly = laiflesli
lifelike = laif¬laik
life’s = laif’s
lifespan = laif¬span
lifespans = laif¬spanes
lifestyle = laifstíl
lifetime = laif¬taim
lifetimes = laiftaimes
lifetime’s = laif¬taim’s
lif = lif
ligh = lai
lightheartedly = lait-hartedli
ligur = ligur
ligur’s = ligur’s
lije = laij
lijes = laijes
likeable = laikabel # el/le
liked = laiked
like = laik
likelier = laiklier
likelihood = laiklihûd
likely = laikli
likeness = laikness
likes = laikes
likewise = laikwaiz
liking = laiking
likings = laikinges
likkered = likered
likker = liker
lik = lik
lila2 = lila
lila = líla
lila’s2 = lila’s
lila’s = líla’s
li’l = li’l
lillys = lilies
lima2 = lima
limbs = limes
lime = laim
limewashed = laimwoshed
limousine = limuzyn
limousines = limuzynes
lincoln = linken
lingerie = lanjeri
lingua = lingua
linguist = linguist
linnaea = linea
lippmanns = lipmanes
lisbon = lisbon
lissen = lisen
listenin = lisenin
liter = liter # er/re
liters = litres # er/re
lithe = laith
lithely = laith¬li
lit’ral = lit’ral
litre = liter # er/re
litres = litres # er/re
littauer = litauer
litterateur = literatur
littleford’s = litelford’s # el/le
liuelong = laivlong
live1 = laiv
live2 = liv
lived = lived
livelier = laivlier
liveliest = laivliest
live = liv
lively = laivli
livened = laivened
livening = laivening
liven = laiven
livens = laivenes
lives1 = laives
lives2 = lives
livestock = laivstok
livin = livin
l = l
’ll = ’l
ll = l
loa = loa
loas = loaes
localway = lókalwei
localways = lókalweies
lockey = loki
lockey’s = loki’s
loggins = logins
loggins’ = logins’
logically = lojikli # kli
lokey = louki
lo = lou
loneliest = lounliest
loneliness = lounliness
lone = loun
lonely = lounli
loner = louner
lonesome = lounsum
longsword = long¬sord
lookin = lûkin
lookit = lûkit
looky = lûki
looooove = luuuuuv
loooove = luuuuv
lopsided = lopsaided
lopsidedly = lopsaidedli
lorenzan = lorenzan
lorenzans = lorenzanes
los = los
lotsa = lotsa
louvre = lôver
lovebird = luvberd
lovebirds = luvberdes
lovelorn = luv¬lorn
lovely = luvli
lovey = luvi
lowie = loui
lowie = louí
lp = lp
lready = lredi
lubricious = lúbricios
lucre = lúker # er/re
lucres = lúkres # er/re
lukewarm = leukworm
lunchbox = lunchboks
lunchtime = lunch¬taim
lungfuls = lungfules
lurched = lerched # eCC
lurches = lerches # eCC
lurching = lerching # eCC
lurch = lerch # eCC
lured = lúred
lure = lúr
lures = lúres
luring = lúring
lurked = lerked
lurker = lerker
lurkers = lerkeres
lurketh = lurkth
lurking = lerking
lurk = lerk
lurks = lerkes
luster = luster # er/re
lusters = lustres # er/re
lustre = luster # er/re
lustres = lustres # er/re
luxurious = luxúrios
luxury = luxúri
lways = lweies
lying = laing
lyin = lain
ly = li
lymer = laimer
lymer’s = laimer’s
lyrane = liran
lysara = lisara
m2 = m2
m4 = m4
m6 = m6
ma’aming = maming
ma’am = mam
macaw = macaú
macaws = macaúes
machicolations = machikoláciones
macramé = makrame
maddened = madened
madeira = madéra
made = meid
mademoiselle = madmuazel
mae = mei
mafeking = mafeking
’mafraidnotsir = ’mafreidnotsur
magnificence = magnificenc
maharaja = maharaja
mahself = maaself
maia = máya
maia’s = máya’s
maidenhead = meidenhed
maidenhead = meydenhed
maiding = meyding
maid’ll = meyd’l
maid = meyd
maids = meydes
maid’s = meyd’s
maize = máiz
majig = majig
make = meik
maker = meiker
maker’s = meiker’s
makes = meikes
makeup = meik¬up
makeweight = meik¬weyt
making = meiking
makin = meikin
malachi = malaki
malachi = malakí
malachy = malaki
malleficarum = malefikarum
malleus = maleus
mamari = mamari
mambuto = mambuto
manaffeh = manafeh
manaus = manaus
mandrake = mandreik
mandrakes = mandreikes
mane = mán
maneuver = manúver # er/re
maneuvers = manúvres # er/re
manipulable = manipúlabel # el/le
mankind = man¬kaind
mankind’s = man¬kaind’s
manlike = manlaik
manoeuvre = manúver # er/re
manoeuvres = manúvres # er/re
mansion = mansion
mansions = mansiones
mantelpiece = mantel¬pyc
mao = mao
maracas = marakas
marcelled = marceled
marengo = marengo
margaretta = margareta
margaritas = margaritaes
marigny = marini
marigny’s = marini’s
marijuana = marihuana
marka = marka
marquee = marké
marquees = markées
marriage = mariaj
marriages = mariajes
married = maried
marries = maries
marrying = mariing
marry = mari
mars = mars
martyrs = martires
maruing = maruing
maru = marû
mashohara = mashohara
maskelyne = maskelain
ma’s = ma’s
massacre = masaker # er/re
massacres = masakres # er/re
mastermind = mastermaind
mated = meited
mate = meit
mates = meites
matinée = matine
matinées = matinees
mating = meiting
matto = mato
matured = matúred
mature = matúr
matures = matúres
maturing = matúring
maturity = matúriti
maud’ve = maúd’v
maugham = maúam
mauled = maúled
mauling = maúling
maul = maúl
mauls = maúles
maupugari = maupugari
mauritius = mauricius
mawnin = moonin
maybe = meiby
mayk = meik
mayn’t = mei’nt
mayo = máyo
mayonnaise = máyonáz
maypole = mei¬poul
maypoles = mei¬poules
maze = meiz
mccabe = makkeib
mccabe’s = makkeib’s
mccarthy = mak-karthi
mccoy = makkoi
mcdavid = mak-dávid
mcewan = makeuan
mcfarland = mak-farland
mcguire = mak-gwair
mclordy = maklordi
meager = méger # er/re
meagers = mégres # er/re
meagre = méger # er/re
meagres = mégres # er/re
mealtime = myl¬taim
mealtimes = myl¬taimes
meanin = mynin
meantime = myntaim
meanwhile = mynwail
measure = mezúr
measures = mezúres
meat = mét
mebbe = mebe
medals = medales
medieval = mediéval
mediocre = medióker # er/re
mediocres = mediókres # er/re
mediterranean = mediteránean
mediuming = médiuming
meds = medes
meet = myt
megatron = megatron
megawatt = mega¬wott
megawatts = mega¬wottes
meggido = megido
megiddo = megido
’melia = ’mélia
melpomene = melpomene
meltin = meltin
member = member
members = membres
memoirs = memuares
memoried = memoried
me = my
ménage = menaj
menapii = menapii
menfolks = menfoukes
menthe = ment
menus = menúes
mercenaries = mercenaries
mercenary = mercenari
merchant = merchant
merchant’s = merchant’s
mercifully⁠ = mercifulli
merciful = merciful
mercilessly = mercilesli
merciless = merciless
mercy = merci
merely = mirli
mere = mir
merest = mirest
merged = merjed
merge = merj
merger = merjer
mergers = merjeres
merges = merjes
merging = merjing
meringue = merang
meringues = meranges
merrier = merier
merriest = meriest
merriment = meriment
merry = meri
mersee = mersy
merteuil = mertei
meself = myself
messin = mesin
mess = mess
metatron = métatron
metatron’s = métatron’s
meteor = méteor
meter = méter # er/re
meters = métres # er/re
metre = méter # er/re
metres = métres # er/re
mettlesome = metelsum
mezoereed = mezoereed
mh = mh
mhoram = mhoram
mi5 = mi5
mi6 = mi6
mi7 = mi7
mi9 = mi9
miasma = miazma
mice = mais
michael = míkel
michelmas = michelmas
microbiological = míkrobíolojikal
microseconds = míkrosekondes
middlin = midlin
midlife = midlaif
midnight = midnait
midsentence = mid¬sentenc
midsummit = mid¬sumit
midwife = midwaif
midwives = midwaives
mightn’t = mait’nt
milady = mileidi
milder = mailder
mildest = maildest
mildly = maildli
mild = maild
milestone = mílstoun
milestones = mílstounes
mili’try = mili’tri
milit’ry = milit’ri
milkshake = milk¬sheik
milkshakes = milk¬sheikes
millane = milan
millionaire = milionár
millionaires = milionáres
minded = mainded
minde = maind
mindful = maindful
minding = mainding
mindless = maindless
mind = maind
minds = maindes
mind’s = maind’s
mine2 = mín
mine = main
mines2 = mínes
mineshafts = mínshaftes
mingle = mingel # el/le
mingles = mingles # el/le
mingling = mingling # el/le
minnit = minit
minnits = minites
mintons = mintones
minty = minti
minty’s = minti’s
mire = mair
mirthful = merth¬ful
mirth = merth
miscarried = miskaried
miscarries = miskaries
miscarryinh = miskariing
miscarry = miskari
mischieve = mischév
mischievously = mischevosli
mischievous = mischevos
mishandled = mis-handled
misjudgment = misjujment
miso = miso
missals = misales
misshapen = mis¬sheipen
missles = misles
mistah = mista
mistakemaker = misteikmeiker
mistake = mis¬teik
mistakenly = misteikenli
mistaken = mis¬teiken
mistakes = mis¬teikes
mistaking = misteiking
mistletoe = miseltou
mistletoes = miseltoues
miter = míter # er/re
miters = mítres # er/re
mitre = míter # er/re
mitres = mítres # er/re
mittened = mitened
miz = miz
m’lady = m’ladi
’m = ’m
m = m
mmh = mmh
mm = mm
mmm = mmm
mmmmmmm = mmmmmmm
mmphph = mmphph
moakely = moukli
moar = mor
modulated = modúláted
modulate = modúlát
modulates = modúlátes
modulating = modúláting
moe’s = mou’s
moey = moui
mohandas = mohandaes
mole = moul
moles = moules
monday = mundei
mondays = mundeies
mongoloids = mongoloides
monney = muni
monsieur = monsiur
montgomery = montgomeri
monzano = monzano
monzano’s = monzano’s
moochy = môchi
moochy’s = môchi’s
moonchild = mônchaild
moonchild’s = mônchaild’s
moonless = mônless
moonlight = mônlait
moonlights = mônlaites
moonrise = mun¬raiz
moonshine = mônshain
moonstone = mônstoun
mooooo = môôôô
mooooooo = môôôôôô
moops = môpes
moped = mouped
mope = moup
mopes = moupes
mopiness = moupiness
moping = mouping
morbilli = morbili
more’n = mor’n
mornin = mornin
morosely = morósli
morose = morós
morphy = morfi
mortgaged = morgajed
mortifie = mortifí
mosaicist = mosaikist
mosaicist = mozáikist
mosaic = mozáik
moseyed = mouzied
moseying = mouziing
mosey = mouzi
moseys = mouzies
mosquitoes = moskitoes
mostest = moustest
mostly = moustli
’most = ’moust
most = moust
mote = mout
motes = moutes
motherless = mutherless
mothmen = mothmen
motorbicycles = mótorbícikles
motorways = mótorweies
mottled = motled # el/le
mottle = motel # el/le
mottles = motles # el/le
mountainside = mauntensaid
mourned = mourned
mourning = mourning
mourn = mourn
mourns = mournes
mouth = mauth
mouthpiece = mauthpyc
mouthpieces = mauthpyces
mouths = mauthes
moveth = môveth
moviegoer = môvigouer
moviegoers = môvigoueres
mowldey = mouldi
mph = mpa
mr = mr
mrs = mrs
ms = ms
muddily = mudili
muffet = mufet
muh = mu
multimillionaire = multimilionár
multimillion = multimilion
multination = multinácion
murchison = murchison
murdered = merdered # eCC
murderer = merderer # eCC
murderers = merdereres # eCC
murderesses = merderesses
murderess = merderess
murdering = merdering # eCC
murder = merder # eCC
murders = merderes # eCC
murray = muri
murrays = muries
murray’s = muri’s
muscled = muscled # el/le
muscle = muscel # el/le
muscles = muscles # el/le
musi = múzi
mus = mus
musta = musta
mustn’t = must’nt
must’ve = must’v
muta = mûta
muzzch = muzch
muzzed = muzed
muzzt = muzt
mye = mai
myers = maieres
mylittleponyer = mailitelponier
myne = main
myrna = mirna
myself = mai¬self
mythologia = mitholojia
mythologi = mitholoji
naboth = naboth
nae = ná
naíve = naiv
naive = nayv
naïve = nayv
naiveté = nayvte
naïveté = nayvte
naivety = nayvti
naïvety = nayvti
naked = neikied
named = neimed
nameless = neimless
name = neim
nameplate = neimplát
namesake = neimseik
namesakes = neimseikes
names = neimes
name’s = neim’s
nametagged = neimtaged
nametag = neimtag
naming = neiming
nana = nana
nana’s = nana’s
nancies = nansies
nancy = nansi
nape = neip
napes = neipes
naphtali = naftali
narker = narker
narnia = narnia
narrowed = naroued
narrower = narouer
narrowing = narouing
narrowly = narouli
narrow = narou
narrows = naroues
naturall = natúral
naturally = natúralli
nauwran = naúwran
navajo = navaho
navajos = navahoes
navarone = navarón
navodny = navodni
naw = noo
nawsuh = noosa
nazis = natsies
nd = nd
nearsightedness = nir¬saited¬ness
nearsighted = nir¬saited
nears = nires
necklace = nek¬lác
necklaces = nek¬láces
necktied = nektaied
necktie = nektai
neckties = nektaies
necrotelecomnicon = nekrotelekomnikon
needin = nydin
needn’t = nyd’nt
neeever = neeever
negro2 = negro
nehies = nyhaies
nehi = nyhai
nehis = nyhaies
neither = nyther
nemennuh = nemenu
nephew = nefeu
nephew = neveu
nephews = nefeues
nephews = neveues
ne’r = ne’r
nerved = nerved
nerve = nerv
nerver = nerver
nerving = nerving
nervously = nervosli
nervous = nervos
nervousness = nervosness
nervy = nervi
nestle = nesel # el/le
nestles = nesles # el/le
nestling = nesling # el/le
netta = neta
netta’s = neta’s
network = net¬werk
networks = net¬werkes
neuroanalysis = neuroanalisis
neuronic = neuronik
neuroses = neuróses
neurosis = neurósis
nevah = neva
nevertheless = nevertheless
nevus = nevus
newel = neuel # el/le
newels = neules # el/le
newsagent = neueságent
newsagents = neueságentes
newscaster = neueskaster
newscasters = neueskasteres
newscast = neues¬cast
newsflashes = neuesflashes
newsflash = neuesflash
news = neues
newsnight = neuesnait
newspaperman = neuespáperman
newspapermen = neuespápermen
newspaper = neuespáper
newspapers = neuespáperes
newsprint = neuesprint
news’ve = neues’v
newsweek = neues¬wyk
newtrition = neutricion
next = nekst
ngh = ngh
ngk = ngk
niceties = nícties
nicety = nícti
nicey = naici
nickname = nikneim
nicknames = nikneimes
nicorn’s = nikorn’s
niece = néc
nieces = néces
niece’s = néc’s
niemi’s = niemi’s
nife = naif
nightdress = naitdress
nightgown = naitgaun
nightgowns = naitgaunes
nightie = naiti
nighties = naities
nightingale = naitingeil
nightingales = naitingeiles
nightmare = nait¬mer
nightmares = nait¬meres
nightmarish = nait¬merish
nightshirt = nait¬shert
nightshirts = nait¬shertes
nighttime = nait¬taim
nigirizushi = nigirizushi
nikki = niki
nilan’s = nilan’s
nilsak = nilsak
nilson = nilsun
nine = nain
ninepence = nainpens
ninepences = nainpenses
nine’s = nain’s
nineteen = naintyn
nineteenth = naintynth
nineties = nainties
ninety = nainti
nin = nin
nippleless = nipelless
nira = nira
nira’s = nira’s
nite = nait
niter = níter # er/re
niters = nítres # er/re
nitre = níter # er/re
nitres = nítres # er/re
nives = naives
n = n
nobody’ll = noubodi’l
nobody = noubodi
nobody’s = noubodi’s
nocatee = nokaty
noiselessly = noizlesli
noiseless = noizless
nominally = nominalli
nonchalant = nonshalant
nongenetically = nonjenetikli # kli
nononono = nounounounou
no = nou
nonsense = nonsens
nonsenses = nonsenses
noo = noou
nope = noup
normalised = normalízed
normally = normalli
normatively = normativli
northeast = north¬yst
northpond = north¬pond
nose = nouz
noses = nouzes
nosey = nouzi
nosin = nouzin
nosir = nousur
nossir = nousur
nostradamuses = nostradamuses
nostradamus = nostradamus
nosy = nouzi
notarized = nótarízed
notarize = nótaríz
noteworthy = nót¬werthi
’nough = ’nuf
novya = novya
nowadays = nauadeies
nowe = nau
nowhere = nouwer
nowheres = nouweres
nozzing = nozing
nozzle = nozel # el/le
nozzles = nozles # el/le
nra = nra
n’s = n’es
nth = nth
n’t = n’t
nuclear = núklear
nucular = núkular
nuffink = nufink
nuff = nuf
nuh = nu
nukerler = núkerler
nukyeler = núkieler
numa = nûma
numa’s = nûma’s
numberless = numberless
nursed = nursed
nurse = nurs
nurses = nurses
nurse’s = nurs’s
nursing = nursing
nuthin = nuthin
nuth = nuth
nutter’s = nuter’s
nuzzle = nuzel # el/le
nuzzles = nuzles # el/le
nuzzling = nuzling # el/le
o2 = ou
o3 = u
oad = oud
oap = oap
obeys = obeies
obidos = obidos
obin’s = obin’s
obnoxiously = obnoxiosli
occultly = okultli
occupied = okúpaied # ai\b
occupies = okúpaies # ai\b
occupying = okúpaing # ai\b
occupy = okúpai # ai\b
occurred = okured
occurring = okuring
ocher = óker # er/re
ochers = ókres # er/re
ochre = óker # er/re
ochres = ókres # er/re
ockatrice = okatric
ock = ok
o’clock = oklok
ocnellio = oknelio
ocnellio’s = oknelio’s
octbr = oktbr
odds = odes
odegra = odegra
’o’d = ’ô’d
odored = ódored
o’erlong = o’erlong
ofd = ovd
offense = ofens
offenses = ofenses
offerin = oferin
officially = oficialli
off’n = of’n
of = ov
ogre = óger # er/re
ogres = ógres # er/re
ogrinsky = ogrinski
o’hara = o’hera
o’hara’s = o’hera’s
ohh = oou
ohnoooeeeeee = ounoooooooou
oh = ou
ohshitohshit = oushitoushit
ohshit = oushit
okay = oukei
oke = oke
ok = oukei
’old = ’old
olei = olei
ole = oul
olga = olga
olga’s = olga’s
’oliday = ’olidei
olivaw = olivoo
olivaw’s = olivoo’s
ollapsible = olapsibel # el/le
ol = ol
o’loy = o’loi
olumn = olumn
olvidares = olvidares
’oman’s = ’ûman’s
’oman = ’ûman
ombuda = ombuda
oment = oment
oment’s = oment’s
ommand = omand
ommm = ommm
ompass = ompas
omplete = omplét
oncet = oncet
once = wuns
onderful = underful
one’d = wun’d
one’ll = wun’l
’ones = ’ones
’onest = ’onest
ones = wunes
one = wun
ongoing = ongouing
onliest = ounliest
onl = onl
onlucan = onlûkan
only = ounli
onlys = ounlies
onne = on
ontario = ontário
onto = onto
onwy = ounwi
o = o
ooer = ôer
oohing = ôing
oohs = ôôes
ook = ôk
ool = ôl
oom = ôm
oon = ôn
’oo = ’ô
oo = ô
oooh = ôô
ooo = ôô
ooooo = ôôôô
oooooooooh = oooooooooo
ooos = ôôes
oor = ôr
’oo’s = ’ô’s
’ootled = ’ôtled
ootled = ôtled
opened = oupened
opening = oupening
openings = oupeninges
openin = oupenin
openly = oupenli
openmouthedly = oupen¬mauthedli
openness = oupen¬ness
open = oupen
opens = oupenes
’ope = ’oup
opera = opera
ophites = ofítes
’op = ’op
opular = opúlar
ordeal = ordél
orgasmic = orgazmik
orgasm = orgazm
orgasm = orgazmes
orgasms = orgazmes
orgeous = orjos
orld = urld
orleans = orléans
orlright = orlrayt
ormerod’s = ormrod’s
’orrid = ’orid
’orrors = ’orores
ositive = ozitiv
oteg = oteg
othere = uther
otherwise = uther¬waiz
’ot = ’ot
ottwell = otwel
’o = ’u
oubliation = oubliation
oubt = aut
oughter = ooter
oughtn’t = oot’nt 
ouldn’t = ûdn’t
ount = aunt
ountry = auntri
our’n = aur’n
ours = aures
ourselve = aurselv
’ouse = ’aus
ouse = aus
outbreak = autbreik
outdoor = autdor
outdoors = autdores
oute = aut
outlaw = autloo
outlawed = autlooed
outlawing = autlooing
outlaws = autlooes
outright = aut¬rayt
outshine = autshain
outshined = autshained
outshines = autshaines
outshining = autshaining
outshone = aut¬shoun
outside = aut¬said
outsider = aut¬saider
outsiders = aut¬saideres
outta = auta
outter = auter
ovah = ova
ovata = ovata
overalled = ouver¬oled
overalls = ouveroles
overanxiety = ouveranzíeti
overbite = ouverbait
overcame = ouverkeim
overcome = ouver¬kum
overcrowded = ouverkrauded
overdecorated = ouverdecoráted
overdecorate = ouverdecorát
overdecorates = ouverdecorátes
overdecorating = ouverdecoráting
overdoes = ouverdus
overdressed = ouver¬dressed
overdrive = ouverdraiv
overheard = ouverhurd # eCC
overlaid = ouver¬leied
over = ouver
override = ouverraid
overripe = ouverraip
oversaw = ouversoo
overscrupulous = ouverskrúpúlos
overseas = ouversées
overseas = ouversées
overseeing = ouversying
oversee = ouversy
overseer = ouver¬syer
overseers = ouver¬syeres
oversees = ouversyes
oversized = ouversaized
overtaken = ouverteiken
overtake = ouverteik
overtakes = ouverteikes
overtaking = ouverteiking
overtasked = ouvertasked
overtasking = ouvertasking
overtask = ouvertask
overtasks = ouvertaskes
overtime = ouvertaim
’ow = ’au
owlde = old
owlsley = oulesli
owlsley’s = oulesli’s
owlsley’s = oulsli’s
oxen = oksen
ox = oks
pabu = pabû
pabu’s = pabû’s
pachwurk = pachwerk
pacious = pácios
paddied = padied
paddlewheels = padelwyles
paddlin = padlin
pageboys = pájboies
paginarum = paginarum
paid = peied
paignton = peintun
painstakingly = pein¬steikingli
painstaking = pein¬steiking
paintwork = peintwerk
paired = páred
pairing = páring
pair = pár
pairs = páres
paleness = pálness
pallida = palida
palms = palmes
panadols = panadoles
pancake = pankeik
pancakes = pankeikes
pane = pán
panes = pánes
paoul = paûl
paphian = pafian
pappardelle = papardelei
paradoxical = páradoxical
paradoxical = páradoxikal
parakeet = párakét
parakeets = párakétes
paravel = paravel
paree = paré
parentage = párentaj
parenting = párenting
parent = párent
parents = párentes
parent’s = párent’s
paris = páris
parley = parle
paroxysm = paroxizm
paroxysms = paroxizmes
parroting = paroting
parrot = parot
parrots = parotes
parrot’s = parot’s
parum = parum
pa’s = pa’s
passerby = paserbai
passersby = paseresbai
pasted = pásted
paste = pást
pastes = pástes
pastime = pastaim
pastimes = pastaimes
pasting = pásting
pâté = pate
paths = pathes
patitur = patitur
patmos = patmos
patreon = patreon
patterne = patern
pausin = paúzin
pavane = pavan
pawn = paún
pawns = paúnes
paw = poo
pawprint = pooprint
pawprints = pooprintes
paws = pooes
payin = pein
payroll = peiról
payroll = peiról
pays = peies
pc = pk
peaceful = pécful
peace = péc
peanut = pénut
peanuts = pénutes
pea = pé
pearl = perl # eCC
pearls = perles # eCC
peas = pées
pecial = pecial
pecs = pekes
peddiwinkus = pediwinkus
pedigreed = pedigréed
pedigree = pedigré
pedro = pedro
peech = pych
peeculiar = pykúliar
peed = pyed
peeing = pying
peen = pyn
pee = py
peering = pyring
pees = pyes
peevish = pyvish
pefko = pefko
penalties = penalties
pence = pens
pence = pens
pencey = penci
penderwick = pen¬der¬wik
penderwicks = pen¬der¬wikes
penderwick’s = pen¬der¬wik’s
penelope’s = penelope’s
penitentiary = penitenciari
penknife = pennaif
people’d = pépel’d
people’ll = pépel’l
people = pépel # el/le
people’s = pépel’s # el/le
peoples = péples # el/le
people’ve = pépel’v
peppa = pepa
perched = perched
perches = perches
perching = perching
perch = perch
pereia = pereia
pereia’s = pereia’s
perfession = perfesion
perfessor = perfesor
perhaps = perhapes
perhaps = perhaps
periwinkle = periwinkel # el/le
periwinkles = periwinkles # el/le
perkinses = perkineses
perkins = perkines
persicifolia = per¬sicifolia
personally = personalli
perspicolia = per¬spikolia
persuaded = persuáded
persuade = persuád
persuades = persuádes
persuading = persuáding
persuasive = persuásiv
perversion = perversion
perversions = perversions
perverted = perverted
perverting = perverting
pervert = pervert
perverts = pervertes
pestinhas = pestinias
pestle = pesel # el/le
pestles = pesles # el/le
petley = petli
petrescence = petrescenc
pew = pú
pews = púes
pharaoh = fárao
pharaohs = fáraoes
pharisee = farisé
pharisees = farisées
phenomenas = fenomenaes
phenomenatrices = fenomenatrices
phenomenice = fenomenic
ph = f
phhuutt = phhuutt
philosophically = filosofikli # kli
photo = fóto
photographable = fótografabel
photos = fótoes
phweet = fwyt
picayune = pikayôn
pickersgill = pikeresgil
piece = pyc
pieces = pyces
pie = pai
pierced = pérced
pierce = pérc
pierces = pérces
piercing = pércing
pietr = pétr
pigalle = pigal
pigbog = pigbog
pigbog’s = pigbog’s
pigtailed = pig¬teyled
pigtail = pig¬teyl
pigtails = pig¬teyles
pile = píl
piles = píles
pilseners = pilseneres
pinko = pinko
pinslinger = pineslinger
pinwheeling = pinwyling
piped = paiped
pipeful = paipful
pipefuls = paipfules
pipe = paip
pipes = paipes
pipestem = paip¬stem
piping = paiping
piranha = pirania
piranhas = piraniaes
piroshkis = piroshkies
pitied = pitied
pities = pities
pitying = pitiing
pity = piti
plagued = pláged
plainclothes = plein¬klouthes
planular = planular
plase = pleis
plashkin = plashkin
plastofilm = plastofilm
platinum = platinum
playgoer = plei¬gouer
playgoers = plei¬goueres
playin = plein
playmate = plei¬meit
playmates = plei¬meites
plays = pleies
plc = plk
pleaded = pléded
pleadingly = plédingli
pleading = pléding
plead = pléd
pleads = plédes
plea = plé
pleasedly = plézedli
pleased = plézed
please = pléz
pleases = plézes
pleasing = plézing
pleas = plées
pleeeeaaaaase = plyyyyyyyyz
pleeze = plyz
plessure = plesúr
ploughshare = plausher
ploughshares = plausheres
plowpusher = plaupûsher
plows = plaues
p’lution = p’lucion
plywood = plíwôd
plywoods = plíwôdes
pneumonia = pneumónia
poignant = poiniant
pointin = pointin
poked = pouked
pokemon = pókemon
pokémon = pókemon
pokemons = pókemones
pokémons = pókemones
poke = pouk
pokes = poukes
pokey = pouki
pokeys = poukies
poking = pouking
pole1 = pól # axis
pole2 = poul # stick
polecat = pólkat
pole = poul
poles1 = póles # axis
poles2 = poules # stick
poles = poules
polipo = polipo
polish1 = pólish
politeness = polítness
politically = politikli # kli
polk = pouk
polonaise = polonáz
polonaises = polonázes
polypol = polipol
pongee = ponjy
pono = pono
pontchartrain = pontshartrein
pony = póni
ponytail = póniteyl
ponytails = póniteyles
poofter = pôftur
pool = pôl
poolside = pôlsaid
poontang = pôntang
poorliness = pôrliness
pootee = pôty
poot = pôt
porridged = porijed
porrit’s = porit’s
positronic = pozitronik
possessed = pozessed
possesses = pozesses
possessing = pozessing
possessin = pozesin
possess = pozess
postscript = póstscript
postscript = póstskript
postscripts = póstskriptes
potentiality = potencialiti
potentially = potencialli
potpourri = popûri
poun = paun
powdered = paudred
powdering = paudring
powder = pauder
powders = paudres
powdery = paudri
powr = paur
p = p
practically = praktikli # kli
praestans = prestans
p’raps = p’raps
pratchett = prachet
pratic’ly = pratikli
prat = prat
prattle = pratel # el/le
prattles = pratles # el/le
prattling = pratling # el/le
prayin = prein
preached = préched
preaches = préches
preaching = préching
preach = préch
prease = préz
’predate = ’predátw
predeceased = predecésed
predecease = predecés
predeceases = predecéses
predeceasing = predecésing
prefered = preferred
prefering = preferring
prefer = preferr
preferred = preferred
preferring = preferring
prefers = preferres
prenup = prenup
prepared = prepáred
prepare = prepár
prepares = prepáres
preparing = prepáring
prepossessed = prepozessed
prepossesses = prepozesses
prepossessing = prepozessing
prepossess = prepozes
pre = pre
prepubescent = prepúbescent
presaged = presajed
prescott’s = preskot’s
presice = presíc
pressed = pressed
presses = presses
pressing = pressing
press = press
presumable = prezúmabel # el/le
presumably = prezúmabli # el/le
presumed = prezúmed
presume = prezúm
presumes = prezúmes
presuming = prezúming
priceless = prícless
prickled = prikled # el/le
prickle = prikel # el/le
prickles = prikles # el/le
prickling = prikling # el/le
prided = praided
pride = praid
prides = praides
priding = praiding
pried = praied
pries = praies
prigging = priging
princesses = princesses
princess = princess
printe = print
printin = printin
pritle = pritel # el/le
prius = prius
privileged = privilejed
prob’ly = prob’li
procedure = procédúr
procedures = procédúres
proceeded = procéded
proceeding = procéding
proceedings = procédinges
proceed = procéd
proceeds = procédes
proclaimed = proklámed
proclaiming = prokláming
proclaim = proklám
proclaims = proklámes
procreation = prokreácion
professionally = profesionalli
professioune = profesion
progenratty = projenrati
pro’lly = pro’li
prophecied = profecied
prophecie = profeci
prophefies = profecies
prop’ly = prop’li
proprietorially = propríetorialli
proselytization = proselitizácion
protein = prótein
protein = prótein
proteins = próteines
protest1 = prótest
protest2 = protest
protests1 = prótestes
protests2 = protestes
providential = providencial
provisionatedly = provizionátedli
pr = pr
pruyea = pruyé
prying = praing
pry = prai
psionics = psíonikes
p’s = p’es
psst = psst
puellae = puele
pug’s = pug’s
pulse = puls
pulsifers = pulsiferes
pulsometer = pulsométer
pulzifer = pulzifer
pumas = púmaes
punctuating = punktúáting
punta = pûnta
purchased = purchaced
purchase = purchac
purchases = purchaces
purchasing = purchacing
purl = perl # eCC
pursed = persed
purse = pers
purse = pers # eCC
purses = perses
purses = perses # eCC
pursing = persing
purty = purti
putin = pûtin
putputput = putputput
putputputputput = putputputputput
putputputputputput = putputputputputput
putrefied = pútrefaied # ai\b
putrefies = pútrefaies # ai\b
putrefying = pútrefaing # ai\b
putrefy = pútrefai # ai\b
putting = pûting
puttin = pûtin
puzzled = puzled # el/le
puzzle = puzel # el/le
puzzles = puzles # el/le
puzzling = puzling # el/le
pvc = pvk
pwactice = pwaktic
pyn = pin
pyramus = piramus
q = q
q’s = q’es
quail = kweil
quails = kweiles
quake = kweik
quaking = kweiking
qualm = kwoom
qualms = kwoomes
quarreled = quoreled # el/le
quarreling = quoreling # el/le
quarrelled = quoreled # el/le
quarrelling = quoreling # el/le
quarrel = quorel # el/le
quarrels = quoreles # el/le
quarry = quori
quartos = quartóes
quawk = kwook
quay = ké
quayside = késaid
queaky = kwyki
queasily = kwyzili
queasiness = kwyziness
queasy = kwyzi
queazily = kwyzili
queazy = kwyzi
queene = kwyn
queen = kwyn
queens = kwynes
queen’s = kwyn’s
queerer = kwirer
queerest = kwirest
queer = kwir
queerly = kwirli
quelled = kweled
quelling = kweling
quellingly = kwelingli
quell = kwel
quells = kweles
questioningly = questioningli
quickened = kwikened
quickening = kwikening
quicken = kwiken
quickens = kwikenes
quicker = kwiker
quickest = kwikest
quick = kwik
quickly = kwikli
quicksand = kwiksand
quicksands = kwiksandes
quicksilveres = kwiksilveres
quidquid = quidquid
quietened = quíetened
quinine = quinin
quinoa = kinóa
quirked = kwerked
quirked = kwurked
quirking = kwerking
quirking = kwurking
quirk = kwerk
quirk = kwurk
quirks = kwerkes
quirks = kwurkes
quirky = kwerki
quitte = quit
quiver = quiver
quoit = koit
quoits = koites
qvvx = qvvx
radios = rádioes
rafael = rafael
raffiawork = rafiawerk
raggle = ragel # el/le
raht = raat
raimy = reimi
raimy’s = reimi’s
raincapes = reinkápes
rainin = reinin
raisin = rázin
raisins = rázines
rajit = rajit
rajits = rajites
rajit’s = rajit’s
raj = raj
raked = reiked
rakehell = reikhel
rake = reik
raker = reiker
rakes = reikes
raking = reiking
rambled = rambled # el/le
ramble = rambel # el/le
rambles = rambles # el/le
rambling = rambling # el/le
ramify = ramifai # ai\b
rape = reip
rappore = rapor
rared = rered
rarer = rárer
rassa = rasa
rassle = rasel # el/le
rasslin = raslin # el/le
rattled = ratled # el/le
rattle = ratel # el/le
rattles = ratles # el/le
rattling = ratling # el/le
raved = ráved
raven = reiven
ravens = reivenes
rave = ráv
raves = ráves
raves = ráves
raw = roo
rayburn = reibern
razorblade = rázorbleid
razorblades = rázorbleides
razor = rázor
reacquainted = reaqueinted
reacquaint = re¬aqueint
read1 = réd
read2 = red
reader = réder
readers = réderes
reading1 = reding # city
reading = réding
readin = rédin
read = réd
reads = rédes
realisation = realizácion
realised = realízed
realise = realíz
realises = realízes
realising = realízing
realism = réalizm
realistic = réalistik
realist = réalist
realists = réalistes
realization = réalizácion
realized = réalízed
realize = réalíz
realizes = réalízes
realizing = réalízing
really = réalli
real = réal
reappearance = reapéranc
reappeared = reapéred
reappearing = reapéring
reappear = reapér
reappears = reapéres
reapplied = reaplaied
reapplies = reaplaies
reapplying = reaplaing
reapply = reaplai
reasonable = rézonabel # el/le
reasonably = rézonabli # el/le
reasoned = rézoned
reasoning = rézoning
reason = rézon
reasons = rézones
reassurance = re¬ashúranc
reassured = reashúred
reassure = reashúr
reassures = reashúres
reassuring = reashúring
reattaching = re¬ataching
reawakening = reaweikening
rebe = rebe
rebind = rebaind
rebirth = reberth
reborn = reborn
rebuilding = rebilding
rebuildings = rebildinges
recall1 = rékol
recall2 = rekol
recalled = rekoled
recalling = rekoling
recall = rekol
recalls = rekoles
recess = recess
recipes = recipees
recircled = recirkled # el/le
recircle = recirkel # el/le
recircles = recirkles # el/le
recircling = recirkling # el/le
reclaimed = reklámed
reclaiming = rekláming
reclaim = reklám
reclaims = reklámes
reconnoiter = rekonoiter # er/re
reconnoiters = rekonoitres # er/re
reconnoitre = rekonoiter # er/re
reconnoitres = rekonoitres # er/re
recreational = rekreácional
recreation = rekreácion
reddened = redened
reddening = redening
redden = reden
reddens = redenes
redde = red
redly = redli
redrawn = redropn
redraw = redrop
redrew = redreu
red’s = red’s
reechoed = reekoed
reechoing = reekoing
reed = ryd
reeds = rydes
reelized = rylízed
reelly = rylli
reely = ryli
reet = ryt
refered = referred
referee = referé
referees = referées
refering = referring
referred = referred
refer = referr
referring = referring
refers = referres
refighting = refaiting
refill1 = réfil
refill2 = refil
refill = refil
refills1 = réfiles
refills2 = refiles
refills = refiles
refugee = refújé
refugees = refújées
refurb = refurb
reggulations = reguláciones
regia = rejia
regional = réjional
region = réjion
regions = réjiones
registered = rejistred # er/re
registering = rejistring # er/re
reg’lar = reg’lar
reglar = reglar
regroups = regrôpes
rehearsal = rehersal
rehearsals = rehersales
rehearsed = rehersed
rehearse = rehers
rehearses = reherses
rehearsing = rehersing
reindeer = reyndyr
reindeers = reyndyres
rein = reyn
reins = reynes
rekilled = rekiled
relatching = relaching
relay = relei
relays = releies
released = relésed
release = relés
releases = reléses
releasing = relésing
relentlessly = relent¬les¬li
relentless = relentless
relied = relaied # ai\b
relief = reléf
relies = relaies # ai\b
relieved = reléved
relieved = reléved
relieved = reléves
relieve = relév
relieve = relév
relieves = reléves
relieving = reléving
relieving = reléving
religion = relijion
religions = relijiones
religio = relijío
religious = relijios
relit = relit
relying = relaing # ai\b
rely = relai # ai\b
remade = remeid
remade = remeid
remake = remeik
remake = remeik
remakes = remeikes
remakes = remeikes
remaking = remeiking
reminded = remainded
reminder = remainder
reminders = remainderes
reminding = remainding
remind = remaind
reminds = remaindes
reminisent = reminisent
remorselessly = remorslesli
remorseless = remorsless
remounted = remaunted
remounting = remaunting
remount = remaunt
remounts = remauntes
remuhmember = remumember
rendezvous = randevô
renfrow = renfrou
reoriented = reoriented
reorienting = reorienting
reorient = reorient
reorients = reorientes
repackaged = repakajed
repackage = repakaj
repackages = repakajes
repackaging = repakajing
repaired = repáred
repairing = repáring
repairman = repárman
repairmen = repármen
repair = repár
repairs = repáres
repared = repáred
repare = repár
repares = repáres
reparing = repáring
repeal = repél
repeatedly = repétedli
repeated = repéted
repeater = repéter
repeaters = repéteres
repeating = repéting
repeat = repét
repeats = repétes
repertoire = repertuar
replied = replaied # ai\b
replies = replaies # ai\b
replying = replaing # ai\b
reply = replai # ai\b
repocalypse = repokalips
reposition = repozicion
repositions = repoziciones
reprieved = repréved
reprieve = reprév
reprieves = repréves
reprieving = repréving
’re = ’r
re = re
reread2 = rered
rereading = reréding
reread = reréd
rereads = rerédes
rer = rer
rescu = reskú
researched = recerched
researches = recerches
researching = recerching
research = recerch
reservoir = rezervuar
reservoirs = rezervuares
residential = rezidencial
resigned = rezíned
resigning = rezíning
resign = rezín
resigns = rezínes
response = respons
restlessness = restlesness
restore = re¬stor
restores = re¬stores
restraint = re¬streint
resumed = rezúmed
resume = rezúm
resumes = rezúmes
resuming = rezúming
retightening = retaitening
retort = retort
retreated = re¬tréted
retreated = retréted
retreating = re¬tréting
retreating = retréting
retreat = re¬trét
retreat = retrét
retreats = re¬trétes
retreats = retrétes
retributive = re¬tribútiv
retributive = retribútiv
retrieval = retréval
retrieved = retréved
retrieve = retrév
retrieves = retréves
retrieving = retréving
reunited = reúníted
reupholstered = re¬uphoulstered
reupholstered = reuphoulstered
reuters = roiteres
revealed = revéled
revealing = revéling
reveal = revél
reveals = revéles
reverentia = reverentia
reversed = reversed
reverse = revers
reverses = reverses
reversing = reversing
reviews = reveues
revoluting = revolúting
rewinding = rewainding
rewrite = re¬rait
rewriter = re¬raiter
rewriters = re¬raiteres
rewrites = re¬raites
rewriting = re¬raiting
rewritten = re¬riten
rewrote = re¬rout
rhien = rhein
rhien’s = rhein’s
rhinestone = rainstoun
rhinestones = rainstounes
rhode = ród
ricketing = riketing
rickie’s = riki’s
riddled = ridled # el/le
riddle = ridel # el/le
riddles = ridles # el/le
riddling = ridling # el/le
ride = raid
rider = raider
riders = raideres
rides = raides
ride’s = raid’s
riding = raiding
ridin = raidin
riend = rend
riffled = rifled # el/le
rifled = raifled # el/le
rifle = raifel # el/le
rifles = raifles # el/le
rifling = raifling # el/le
rigamarole = rigamaról
righ = ray
righted = rayted
righteously = rayteosli
righteousness = rayteosness
righteous = rayteos
rightfully = raytfulli
rightly = rayt¬li
right = rayt
rightside = raytsaid
rights = raytes
riley = raili
rimless = rimless
rincess = rincess
ripened = raipened
ripening = raipening
ripen = raipen
ripens = raipenes
ripe = raip
ripple = ripel # el/le
ripples = riples # el/le
rippling = ripling # el/le
ri = ri
rise = raiz
riser = raizer
risers = raizeres
rises = raizes
riseth = raizeth
rising = raizing
riumphant = ríumfant
rms = rms
roadhouse = roudhaus
roadhouses = roudhauses
roadside = roudsaid
robear = robear
robey = roubi
robeys = roubies
robinette = robinet
robinettes = robinetes
robinette’s = robinet’s
roboticist = róboticist
roboticity = róboticiti
rockabye = rokabai
rockslide = rokslaid
rockslides = rokslaides
rocodile = rokodíl
rode = roud
rod’s = rod’s
roget = roje
rogued = róged
rogueing = róging
rogue = róg
roguery = rógeri
rogues = róges
roguing = róging
rois = rois
rois’s = rois’s
roj = roj
role = ról
roll1 = ról
rolled = róled
rolling = róling
roll = ról
rolls1 = róles
rolls = róles
roly = roli
romantically = romantikli # kli
romontory = romontori
ronan = ronan
ronans = ronanes
ronans = ronanes
ronan’s = ronan’s
roommate = rômmeit
roommates = rômmeites
rooted = rûted
rooting = rûting
root = rût
roots = rûtes
rope = roup
ropes = roupes
rose1 = róz
rose2 = rouz
rosecraft = rouzkraft
rosecraft’s = rouzkraft’s
rose = rouz
roses = rózes
rossum = rosum
rottenweiler = rotwailer
rottenweilers = rotwaileres
rouche = rûsh
roughened = rufened
roughs = rufes
’roun = ’raun
roun = raun
roused = rauzed
rouse = rauz
rouses = rauzes
rousing = rauzing
routed = rôted
router = rôter
routers = rôteres
routing = rôting
rout = rôt
routs = rôtes
rownish = raunish
rows = roues
royalist = royalist
royalists = royalistes
royally = royalli
royal = royal
royalty’s = royalti’s
’r = ’r
r = r
r’s = r’s
rs = rs
rubbishe = rubish
rudbeckia = rudbekia
rueful = reuful
ruffled = rufled # el/le
rumfoord = rumford
rumfoords = rumfordes
rummaged = rumajed
runnel = runel # el/le
runnels = runles # el/le
runne = run
runneth = runeth
russian = rusian
rustled = rusled # el/le
rustlers = rusleres
rustle = rusel # el/le
rustles = rusles # el/le
rustling = rusling # el/le
ruthful = reuthful
ruthless = reuth¬less
ruth = reuth
ryde = raid
rydes = raides
ryght = rayt
ryte = rayt
sabbat = sabat
saber = sáber # er/re
sabers = sábres # er/re
sabre = sáber # er/re
sabres = sábres # er/re
saccharomyces = sakaromíses
sachet = sashe
saddler = sadler # el/le
saddlers = sadleres # el/le
saddle = sadel # el/le
saddles = sadles # el/le
safeguard = seif¬gard
safeguards = seif¬gardes
safely = seifli
safer = seifer
safe = seif
safest = seifest
safety = seifti
safety’s = seifti’s
sagely = sáj¬li
sailboat = seylbout
sailboats = seylboutes
sailed = seyled
sailing = seyling
sailor = seyler
sailors = seyleres
sail = seyl
sails = seyles
sainsbury’s = seinsberi’s
sake = seik
sakes = seikes
saldanas = saldanaes
salesbook = seiles¬bûk
sale = seil
salesladies = seiles¬leidies
saleslady = seiles¬leidi
salesman = seiles¬man
salesmanship = seiles¬manship
salesmen = seiles¬men
salespeople = seiles¬pépel
salesperson = seiles¬person
salespersons = seiles¬persones
salesroom = seiles¬rôm
sales = seiles
saltpeter = saltpéter # er/re
saltpeters = saltpétres # er/re
saltpetre = saltpéter # er/re
saltpetres = saltpétres # er/re
’salways = ’solweies
same = seim
same’s = seim’s
sampled = sampled # el/le
sample = sampel # el/le
samples = samples # el/le
sampling = sampling # el/le
sangre = sangre
sanibel = sanibel
santarem = santarem
santorinis = santorinies
sao = sau
sapientiae = sapientie
sarasota = sarasóta
sarcasm = sarkazm
sardonically = sardonikli # kli
sarooned = sarôned
sarton = sarton
sashaying = sasheing
sass = sas
sass’s = sas’s
satiated = sáciáted
satiate = sáciát
satiates = sáciátes
satiating = sáciáting
satis = satis
saturday = saturdei
saturdays = saturdeies
saul’s = saúl’s
sauntered = soontered
sauntering = soontering
saunter = soonter
saunters = soonteres
sautéed = sóteed
sauté = sóte
saved = seived
saveloys = saveloies
save = seiv
saves = seives
saving = seiving
sawmill = soomil
saw = soo
sayin = sein
says = ses
scagges = skages
scale1 = skál
scale2 = skeil # to measure weight
scales1 = skáles
scales2 = skeiles # to measure weight
scale = skál
scannel = skanel
scaramouche = skaramôsh
scarcely = skársli
scarce = skárs
scared = skered
scare = sker
scares = skeres
scarier = skerier
scariest = skeriest
scaring = skering
scarlett = skarlet
scarlett’s = skarlet’s
scary = skeri
scathed = skeithed
scathe = skeith
scathes = skeithes
scathing = skeithing
scented = sented
scenting = senting
scent = sent
scents = sentes
scheherazade = sheherazad
schistosomiasis = shistosómíasis
schizophrenia = skitsofrénia
schlichter = shlihter
schmear = shmyr
schnauzer = shnautser
schnauzers = scnautsers
schnauzers = shnautseres
schoolchild = skôlchaild
schoolmates = skôlmeites
sci = scí
scolds = skoldes
scone = skoun
scones = skounes
scooched = skôched
scraggled = skragled # el/le
scraggle = skragel # el/le
scraggles = skragles # el/le
scraggling = skragling # el/le
scraped = skreiped
scrape = skreip
scrapes = skreipes
scraping = skreiping
scrawled = skrooled
scrawling = skrooling
scrawl = skrool
scrawls = skrooles
scrawny = skrooni
screem = skrym
screened = skréned
screening = skréning
screenplay = skrénplei
screen = skrén
screens = skrénes
screwdriver = skreudraiver
screwdrivers = skreudraiveres
screw = skreu
screws = skreues
scribble = skribel # el/le
scribbles = skribles # el/le
scribbling = skribling # el/le
scroggie = skrogi
scroggie’s = skrogi’s
scruples = skrúples
’scuse = ’skúz
scythed = saithed
scythe = saith
scythes = saithes
scything = saithing
scythin = scithin
seabed = sé¬bed
seafood = sé¬fôd
seaman = sé-man
seamen = sé-men
seam = sém
seams = sémes
seamstresses = sémstresses
seamstress = sémstress
seamstress’s = sémstress’s
seance = seanc
seances = seances
search = cerch # eCC
searched = cerched # eCC
searcher = cercher # eCC
searchers = cercheres # eCC
searches = cerches # eCC
searching = cerching # eCC
searchings = cerchinges # eCC
sea = sé
seashell = sé¬shel
seashells = sé¬sheles
seashore = sé¬shor
seasickness = sé¬sikness
seasick = sé¬sik
seasonal = sézonal
season = sézon
seasons = sézones
seas = sées
seatcovers = sytkuveres
seaward = séword
seawater = sé¬woter
seaweed = sé¬wyd
seaworthy = séwerthi
sebaceous = sebácios
seducin = sedúcin
seein = syin
seemed = symed
seeming = syming
seems = symes
seem = sym
seen = syn
seesaws = sy¬sooes
seesaw = sy¬soo
sees = syes
see = sy
sei = sei
selfie = selfi
selfies = selfies
selflessness = selflesness
selfwesswy = selfweswi
selkies = selkies
semicircle = semicirkel
semi = semi
senhora = seniora
senhorita = seniorita
senhor = senior
senhors = seniores
sensed = sensed
sense = sens
senses = senses
sensing = sensing
sen’s = sen’s
separately = separatli
sep’rate = sep’rát
sepulcher = sepulker # er/re
sepulchers = sepulkres # er/re
sepulchre = sepulker # er/re
sepulchres = sepulkres # er/re
sergei = sergei
sergei’s = sergei’s
sergio = serjio
serg = sarj
seriouzz = sérioz
serpente = surpente
serpentine = serpentín
serpent = serpent
serpents = serpentes
serried = seried
serries = series
serrying = seriing
serry = seri
servants’ve = servants’v
se = sy
sethites = sethítes
settled = setled # el/le
settle = setel # el/le
settles = setles # el/le
settling = setling # el/le
sevedi = sevedi
sevedi’s = sevedi’s
sevenpence = sevenpens
several = several
sewed = swoued
sewing = swouing
sewn = swoun
sews = swoues
sew = swou
sexuality = sexúaliti
sexual = sexúal
sez = sez
sf = sf
’sgotta = ’sgota
sgt = sjt
shaded = sheided
shade = sheid
shades = sheides
shading = sheiding
shadow = shadoues
shadows = shadoues
shady = sheidi
shaken = sheiken
shaker = sheiker
shake = sheik
shakespeare = sheikspir
shakespeare’s = sheikspir’s
shakes = sheikes
shaking = sheiking
shaky = sheiki
shalle = shal
shallowly = shalouli
shal = shal
shambala = shambala
shamed = sheimed
shamefaced = sheimfáced
shameless = sheimless
shame = sheim
shames = sheimes
shame’s = sheim’s
shaming = sheiming
shan’t = sha’nt
shaped = sheiped
shapeless = sheipless
shapely = sheipli
shape = sheip
shapeshifted = sheipshifted
shapeshifter = sheipshifter
shapeshifting = sheipshifting
shapes = sheipes
shaping = sheiping
shared = shered
shareholder = sherholder
shareholders = sherholderes
share = sher
shares = sheres
sharing = shering
sharle = sharel
sharl = sharl
shaved = sheived
shaven = sheiven
shaver = sheiver
shave = sheiv
shaves = sheives
shaving = sheiving
shawl = shool
shawls = shooles
shawl’s = shool’s
shaw = shoo
shecks = shekes
shecks = sheks
she’d = shy’d
sheena = shyna
sheena’s = shyna’s
shee = shy
sheik = sheik
she’ll = shy’l
shell’s = shel’s
sherryl = sheril
sherwoode = sherwûd
she = shy
she’s = shy’s
she’ve = shy’v
shewn = shoun
shh = shh
shied = shaied
shies = shaies
shimmied = shimied
shimmies = shimies
shined = shained
shine = shain
shines = shaines
shiniest = shainiest
shinik = shinik
shininess = shaininess
shining = shaining
shinny = shini
shiny = shaini
shirked = sherked
shirking = sherking
shirk = sherk
shirks = sherkes
shirted = sherted
shirtless = shert¬less # eCC
shirtlifter = shert¬lifter
shirt = shert # eCC
shirtsleeve = shert¬slyv
shirtsleeves = shert¬slyves
shirts = shertes # eCC
shirty = sherti
shiv = shiv
shmomantic = shmomantik
shoat = shout
shockwave = shokweiv
shoeless = shôless
shoes = shôes
shone = shoun
shootin = shôtin
sho = shû
shoulde = shûd
shouldn’t = shûd’nt
shoutin = shautin
shoveling = shuveling # el/le
shovelling = shuveling # el/le
shovel = shuvel # el/le
shovels = shuveles # el/le
showoffs = shouofes
showroom = shourôm
showrooms = shourômes
shows = shoues
shrine = shrín
shrines = shrínes
sh = sh
shuffled = shufled # el/le
shuffle = shufel # el/le
shuffles = shufles # el/le
shuffling = shufling # el/le
shutup = shutup
shutzi = shutsi
shutzi’s = shutsi’s
shying = shaing
shyness = shainess
shy = shai
shyster = shaister # er/re
shysters = shaistres # er/re
siblinghood = siblinghûd
sickie = siki
sideboard = saidbord
sidekick = saidkik
sidekicks = saidkikes
sidelong = saidlong
sidesaddle = said¬sadl
side = said
sides = saides
’sides = ’saidz
sidestepped = said¬steped
sidestepping = said¬steping
sidestep = said¬step
sidesteps = said¬stepes
sidetracked = saidtraked
sidewalk = saidwook
sideways = saidweiz
sidewindin = saidwindin
sidhean = shéon
siding = saiding
sidings = saidinges
sidled = saidled # el/le
sidle = saidel # el/le
sidles = saidles # el/le
sidling = saidling # el/le
siege = séj
sighed = saied
sighing = saing
sigh = sai
sighs = saies
sighted = saited
sight = sait
sights = saites
sigil = sijil
sigils = sijiles
signed = síned
signify = signifai # ai\b
signing = síning
signposted = sínpósted
signposting = sínpósting
signpost = sínpóst
signpost = sínpóst
signposts = sínpóstes
sign = sín
signs = sínes
silas = sílas
silas’s = sílas’s
silenzz = sílenz
sile = sail
siles = sailes
silhouette = siluet
silhouetto = silueto
siloam = siloum
silura = silura
simpleness = simpelness
simpler = simpler
simpleton = simpelton
simpletons = simpeltones
sincerest = sincérest
since = sins
sindy = sindi
singin = singin
sinookas = sinôkaes
sion = sion
sireee = suuur
sitch = sich
site = sait
site = sít
sites = saites
sites = sítes
sittin = sitin
sixes = sikses
sixpence = sikspens
sixpences = sikspenses
six = siks
sixteene = sikstyn
sixteen = sikstyn
sixteenth = sikstynth
sixth = siksth
sixties = siksties
sixtieth = sikstith
sixty = siksti
sizable = saizabel # el/le
sized = saized
size = saiz
sizes = saizes
sizing = saizing
sizzled = sizled # el/le
sizzle = sizel # el/le
sizzles = sizles # el/le
sizzling = sizling # el/le
skateboarded = skeitborded
skateboarding = skeitbording
skateboard = skeitbord
skateboards = skeitbordes
skated = skeited
skater = skeiter
skaters = skeiteres
skate = skeit
skates = skeites
skating = skeiting
skidmark = skidmark
skied = skyed
skies = skaies
skif = skif
skif’s = skif’s
skiing = skying
skindle’s = skindel’s
skinnie = skiny
skinnin = skinin
skirmishes = skermishes
skirmish = skermish
skirting = skerting
skirt = skert
skirts = skertes
ski = sky
skis = skyes
sk = sk
skuzz = skuz
skye = skai
skye = skay
skye’s = skai’s
skye’s = skay’s
skyline = skai¬lín
skyrocketed = skairoketed
skyrocketing = skairoketing
skyrocket = skairoket
skyrockets = skairoketes
sky = skai
sky’s = skai’s
slate = slát
slates = slátes
slayeth = sleith
sleat = slyt
sleepeth = slypeth
sleepwalking = slypwooking
sliced = slíced
slice = slíc
slices = slíces
slicing = slícing
slided = slaided
slide = slaid
slides = slaides
sliding = slaiding
slighter = slaiter
slightest = slaitest
slight = slait
slime = slaim
slimline = slaimlín
slimy = slaimi
sloped = slouped
slope = sloup
slopes = sloupes
sloping = slouping
sloth = slouth
sloths = slouthes
slouchy = slauch
slurped = slerped
slurping = slerping
slurp = slerp
slurps = slerpes
slyly = slaili
slyness = slainess
smears = smires
smiled = smailed
smile = smail
smiles = smailes
smiling = smailing
smirked = smerked # eCC
smirkier = smerkier
smirking = smerking # eCC
smirkish = smerkish
smirk = smerk # eCC
smirks = smerkes # eCC
smited = smaited
smite = smait
smite = smait
smites = smaites
smith’ve = smith’v
smiting = smaiting
smitten = smiten
smoked = smouked
smoker = smouker
smoke = smouk
smokes = smoukes
smoking = smouking
smoky = smouki
smote = smout
smythe = smaith
snaggle = snagel # el/le
snaked = sneiked
snakeskin = sneikskin
snake = sneik
snakes = sneikes
snaking = sneiking
snare = sner
snarky = snarki
’s’nice = ’s’níc
snide = snaid
sniffle = snifel # el/le
sniffles = snifles # el/le
sniffling = snifling # el/le
sniped = snaiped
snipe = snaip
snipes = snaipes
sniping = snaiping
’snot = ’snot
s’not = s’not
snowboarding = snoubording
snowboard = snoubord
snowboards = snoubordes
snowflake = snoufleik
snowflakes = snoufleikes
snuffled = snufled # el/le
snuffle = snufel # el/le
snuffles = snufles # el/le
snuffling = snufling # el/le
snuggle = snugel # el/le
snuggles = snugles # el/le
snuggling = snugling # el/le
sodomitical = sodomítikal
soe = sóu
sofas = sófaes
soho = souhou
solanya = solanya
soldier = soldier
soldiers = soldieres
solely = sólli
somberness = somberness
somber = somber # er/re
sombers = sombres # er/re
sombre = somber # er/re
sombres = sombres # er/re
some’ll = sum’l
somersaults = sumersaúltes
somersault = sumersolt
somerset = sumerset
sometimes = sumtaimes
sometime = sumtaim
somewhar = sumwar
somno = somno
sonofabitch = sunnovabich
sons = sunnes
son = sunn
sooo = sooou
sophomore = sofomor
sorrowfully = soroufulli
so = sou
sos = sos
so’s = sou’s
soufflé = sufle
soulfully = soulfulli
soulful = soulful
soulllllls = soulllllles
soullllls = soullllles
soul = soul
souls = soules
soun = saun
sourdough = saurdou
southeast = sauth¬yst
southernmost = suthern¬moust
southwarke = suthark
southwark = suthark
sovereign = sovren
sovereigns = sovrenes
sovs = soves
sow1 = sau
sow2 = sou
sowed = sowed
sowing = sowing
sown = sown
sow = sow
sows = sowes
spade = speid
spades = speides
spake = speik
spared = spered
spare = sper
spares = speres
sparingly = speiringli
sparing = spering
sparrow = sparou
sparrows = sparoues
sparser = sparser
sparse = spars
spasmed = spazmed
spasming = spazming
spasm = spazm
spasms = spazmes
spate = speit
spates = speites
spawn = spaún
spears = spires
’specially = ’specialli
specially = specialli
species = spécies
specify = specifai # ai\b
spectacles = spektakles
specter = spekter # er/re
specters = spektres # er/re
spectre = spekter # er/re
spectres = spektres # er/re
’spect = ’spekt
s’pect = s’pekt
spiddon = spidon
spider = spaider
spiders = spaideres
spider’s = spaider’s
spiderweb = spaider¬web
spiel = shpyl
spiels = shpyles
spies = spaies # ai\b
spiked = spaiked
spike = spaik
spikes = spaikes
spiking = spaiking
spillin = spilin
spindle = spindel # el/le
spindles = spindles # el/le
spindling = spindling # el/le
spiraea = spírea
spirituality = spiritúaliti
spite = spít
spitfire = spitfair
spittle = spitel # el/le
splish = splish
spoken = spouken
spokesman = spoukes¬man
spokesman’s = spoukes¬man’s
spokesmen = spoukes¬men
spokesmen’s = spoukes¬men’s
spokesperson = spoukes¬person
spokespersons = spoukes¬persones
spoke = spouk
spoonsful = spônesful
s’posed = s’pózed
sposen = spouzen
s’pose = s’pouz
spose = spóz
spottiness = spotiness
s’pposed = s’pózed
spraddle = spradel # el/le
sprawled = sprooled
sprawling = sprooling
sprawl = sprool
sprawls = sprooles
sprayin = sprein
springtime = springtaim
sprinkled = sprinkled
spy = spai # ai\b
spy’s = spai’s # ai\b
squabbled = skwobled # el/le
squabble = skwobel # el/le
squabbles = skwobles # el/le
squabbling = skwobling # el/le
squalor = squolor
squalors = squolores
squandered = skwondred # er/re
squandering = skwondring # er/re
squander = skwonder # er/re
squanders = skwondres # er/re
squared = squáred
square = squár
squares = squáres
squaring = squáring
squat = squot
squats = squotes
squatted = squoted
squatting = squoting
squawked = skwooked
squawking = skwooking
squawk = skwook
squawks = skwookes
squeaked = skwyked
squeaking = skwyking
squeak = skwyk
squeaks = skwykes
squeaky = skwyki
squealed = skwyled
squealer = skwyler
squealers = skwyleres
squealing = skwyling
squeal = skwyl
squeals = skwyles
squeamish = skwymish
squeezed = skwyzed
squeeze = skwyz
squeezes = skwyzes
squeezing = skwyzing
squelched = skwelched
squelches = skwelches
squelching = skwelching
squelch = skwelch
squelchy = skwelchi
squinted = skwinted
squinting = skwinting
squint = skwint
squints = skwintes
squinty = skwinti
squireship = squírship
squirmed = skwermed
squirming = skwerming
squirm = skwerm
squirms = skwermes
squirrel = squirrel
squirrel = squirrel # eCC
squirrels = squirreles
squirted = skwerted # eCC
squirting = skwerting # eCC
squirt = skwert # eCC
squirts = skwertes # eCC
squishiness = skwishiness
squishing = squishing
sr = sr
s = s
ssw = ssw
stablehand = steibelhand
stables = steibles # el/le
stable = steibel # el/le
stackable = stakabel
stairs = steires
stair = steir
staked = steiked
stakes = steikes
stake = steik
staking = steiking
staled = steiled
stales = steiles
stale = steil
staling = steiling
stanca = stanka
standbys = standbaies
standees = standyes
standz = standz
stapled = steipled # el/le
staple’s = steipel’s # el/le
staples = steiples # el/le
staple = steipel # el/le
stapling = steipling
stared = stered
stares = steres
stare = ster
staring = stering
starred = stared
starring = staring
starry = stari
startin = startin
startled = startled # el/le
startles = startles # el/le
startle = startel # el/le
startling = startling # el/le
stately = státli
states = státes
stationaries = stácionáries
stationary = stácionári
staved = steived
staves = steives
stave = steiv
staving = steiving
stays = steies
stealing = stéling
steals = stéles
steal = stél
steeple = stypel # el/le
steering = styring
steez = styz
stellaaah = stelaaaa
stephenson’s = stévensun’s
stephenson = stévensun
stepson = step¬sunn
sternly = sternli
sterno = sterno
stern = stern
stifled = staifled
stifled = staifled # el/le
stifles = staifles
stifles = staifles # el/le
stifle = staifel
stifle = staifel # el/le
stiflingly = staiflingli
stifling = staifling
stifling = staifling # el/le
stiled = stailed
stiles’s = stailes’s
stiles = stailes
stile = stail
stiling = stailing
stilly = stilli
stirred = stured
stirrings = sturinges
stirring = sturing
stirrin = sturin
stirrups = stir¬upes
stirrup = sterrup
stirrup = stir¬up
stirs = stures
stoked = stouked
stokes’s = stoukes’s
stokes = stoukes
stokes = stoukes
stoke = stouk
stoking = stouking
stolen = stoulen
stole = stoul
stomachs = stumakes
stomach = stumak
stomak = stomak
stompin = stompin
stonehenge = stoun¬henj
stones = stounes
stone = stoun
stonewalled = stounwoled
stonewall = stounwol
stony = stouni
stopf = stopf
stopple = stopel # el/le
stored = stored
storme = storm
stoves = stouves
stove = stouv
stowaways = stou¬aweies
stowaway = stou¬awei
straight = streit
strait = strát
strawberries = strooberies
strawberry = strooberi
straws = strooes
straw = stroo
streetlights = strétlaites
streetlight = strétlait
streets = strétes
street = strét
stretchy = strechi
strides = straides
stride = straid
striding = straiding
strifes = strífes
strife = stríf
striked = straiked
strikes = straikes
strike = straik
strikingly = straikingli
striking = straiking
striped = straiped
stripes = straipes
stripe = straip
strive = strív
strode = stroud
stroked = strouked
strokes = stroukes
stroke = strouk
stroking = strouking
strolled = strouled
strolling = strouling
strolls = stroules
stroll = stroul
stronge = strong
strove = strouv
st = st
stubbs = stubes
studyin = studiin
stumbled = stumbled # el/le
stumbles = stumbles # el/le
stumble = stumbel # el/le
stumbling = stumbling # el/le
stuppa = stupa
sturdier = sterdier
sturdiest = sterdiest
sturdy = sterdi
substantial = substancial
succeeded = sukcéded
succeeding = sukcéding
succeeds = sukcédes
succeed = sukcéd
successfully = sukcesfulli
successful = sukcesful
success = sukcess
suche = such
suchlike = such¬laik
suckin = sukin
suckled = sukled # el/le
suckle = sukel # el/le
suckling = sukling # el/le
sucksby’s = sukesbi’s
sucksby’s = suksbi’s
sucksby = sukesbi
sucksby = suksbi
suede = sweid
sue’s = sú’s
sue = sú
sufferin = suferin
sugar = shûgar
sugar’s = shûgar’s
sugary = shûgari
suggestin = sugjestin
suiter’s = súter’s
suiter = súter
suites = sûytes
suite = sûyt
suky = suki
sulfathiazole = sulfathíazól
summed = summed
summing = summing
sump’in = sump’in
sums = summes
sum = summ
sunbathed = sunbeithed
sunbathes = sunbeithes
sunbathe = sunbeith
sunbathing = sun¬beithing
sunbathing = sunbeithing
sunburst = sunberst
sundays = sundeies
sunday = sundei
sunneshain = sunshain
sunrises = sunraizes
sunrise = sunraiz
sunshade = sunsheid
sunshine = sunshain
suns = sunes
sun’s = sun’s
sunstroke = sunstrouk
sun = sun
superfluous = súperfluos
suppertime = supertaim
supplement = suplement
supplied = suplaied # ai\b
supplies = suplaies # ai\b
supplying = suplaing # ai\b
supply = suplai # ai\b
surefire = shúrfair
surely = shúrli
sure = shúr
surety = shúriti
surgeons = surjenes
surgeon = surjen
surnames = sur¬neimes
surname = sur¬neim
surrealistic = suréalistik
surreal = suréal
surrey = suri
surrogacy = surogaci
surrogate = surogat
surveilled = surveiled
surveyed = surveied
surveying = surveing
surveys = surveies
sushi = sûshi
suv = súv
swaggit = swagit
sweatshirts = swet¬shertes
sweatshirt = swet¬shert
sweetfaced = swyt¬fáced
swimmin = swimin
swindlers = swindleres
swindler = swindler
swirled = swerled # eCC
swirling = swerling # eCC
swirls = swerles # eCC
swirl = swerl # eCC
swollen = swoulen
swordsman = sordes¬man
swordsmen = sordes¬men
sword = sord
swords = sordes
sykeses = saikeses
sykes = saikes
sykes’s = saikes’s
sylacauga = silakooga
sylvina = silvina
sympathique = simpathik
synapse = sinaps
syrup = sirup
systematically = sistematikli # kli
szechuan = sechuan
tabbed = tabed
tabernid = tabernid
tabitha’s2 = tabitha’s
tableau = tabló
tacete = tacete
taddes = tades
taddville = tadvil
tadfield = tadfyld
tadpoles = tadpoules
tadpole = tadpoul
tagliatelli = taliateli
tailback = teyl¬bak
tailed = teyled
tailforwards = teylforwordes
tailgate = teylgeit
tailing = teyling
tailin = teylin
tailors = teyleres
tailor’s = teyler’s
tailor = teyler
tails = teyles
tail = teyl
taiwan = taiwan
tajupi = tajupi
taken = teiken
takes = teikes
take = teik
taking = teiking
takin = teikin
talapi = talapi
tales = teiles
tale = teil
talkin = tookin
talks = tookes
tallywhacker = taliwaker
tamales = tamalees
tamale = tamale
tamed = teimed
tames = teimes
tamest = teimest
tame = teim
taming = teiming
tandry = tandri
tangled = tangled # el/le
tanglefoot = tangelfût # el/le
tangle = tangel # el/le
tapas = tapaes
tapa = tapa
taped = teiped
taped = teiped
taped = teiped
tapes = teipes
tapes = teipes
tape = teip
tapherini = tapherini
taping = teiping
taping = teiping
taping = teiping
tapi’s = tapi’s
tapi = tapi
tapuri = tapuri
tara = tera
tardesfield = tardesfyld
tardie = tardi
tardin = tardin
tard = tard
tarsola = tarsola
tassels = tasles # el/le
tasted = teisted
tasteful = teistful
tastes = teistes
taste = teist
tasting = teisting
tasty = teisti
tattled = tatled # el/le
tattle = tatel # el/le
tattling = tatling # el/le
tattoos = tatôes
tattoo = tatô
taupe = tóp
taut = toot
taverner’s = taverner’s
tawdry = toodri
tawny = taúni
taw = too
taxis = taxies
tbi = tbi
tchaikovsky = chaikovski
tchaikovsky’s = chaikovski’s
tch = tch
teacups = tékupes
teacup = tékup
tea’ll = té’l
teapots = tépotes
teapot = tépot
tear1 = tir
tear2 = ter
teared = tired
tearful = tirful
tearing = tering
tears1 = tires
tears2 = teres
teas = tées
tea’s = té’s
tea = té
teatime = tétaim
teatra = teatra
techniques = teknykes
technique = teknyk
teepees = typyes
teetron = tytron
telegrapher’s = telegrafer’s
telexes = telexes
telle = tel
tellin = telin
temptation = temptácion
’tend = ’tend
tenfold = ten¬fold
tense = tens
tensions = tensiones
tension = tension
tepees = tépyes
tephen = téven
terminus = terminus
terms = termes
tero = tero
terrapins = terapines
terrapin = terapin
terrel’s = terel’s
terrel = terel
terries = teries
testeth = testeth
testified = testifaied # ai\b
testifies = testifaies # ai\b
testifying = testifaing # ai\b
testify = testifai # ai\b
teutonic = teutonik
teven = téven
thanksgiving = thankesgiving
thaon’s = thaon’s
thaon = thaon
thar’s = thar’s
thass = thas
tha’s = tha’s
that’s = that’s
that’z = that’z
thawed = thooed
thawing = thooing
thaws = thooes
thaw = thoo
theaters = théatres # er/re
theater = théater # er/re
theatres = théatres # er/re
theatre = théater # er/re
theatrics = théatrikes
thee = thy
theirs = theires
their = their
themme = them
theodosius = theodosius
theologians = theolójianes
theologian = theolójian
theophilus = theofilus
theoretical = théoretikal
theories = théories
theorised = théorízed
theorises = théorízes
theorise = théoríz
theorising = théorízing
theorized = théorízed
theorizes = théorízes
theorize = théoríz
theorizing = théorízing
theory = théori
there’ll = ther’l
there’r = ther’r
there’s = ther’s
thereupon = therupon
thermonuclear = thermonúklear
these’ll = thyz’l
these = thyz
theye = thei
they’m = thei’m
they’re = thei’r
they’r = thei’r
theyr = their
they’s = thei’s
they’ve = thei’v
thiago = thiago
thievinge = thyving
thif = thif
thighs = thaies
thigh = thai
thimblerig = thimbelrig # el/le
thimble = thimbel # el/le
thine = thain
things’ve = thinges’v
thingz = thingz
third = therd # eCC
thirst = therst
thirsty = thersti
thirteen = thertyn
thirteenth = thertynth
thirty = therti
thisbes = thisbes
thish = thish
’this = ’this
thistledown = thiseldaun # el/le
thizz = thiz
thornbowe = thornbou
thoroughbred = thuroubred
thoroughly = thurouli
thoroughness = thurouness
thorough = thurou
those = thouz
thos = thos
thousandfold = thauzandfold
threadbare = thredbeir
threadlike = thredlaik
threepence = thrypens
threes = thryes
threlfall = threlfol
threw = threu
thrice = thrais
thrived = thraived
thrives = thraives
thrive = thraiv
thriving = thraiving
throes = thróes
throe = thró
throug = thrô
throws = throues
thr = thr
thrupences = thrupenses
thrupenny = thrupeni
thrup = thrup
th = th
thumbs = thumes
thundergun’s = thundergun’s
thundergun = thundergun
thundertank = thundertank
thursdays = thuresdeies
thursday = thuresdei
thwonk = thwonk
thydric’s = thídrik’s
thydric = thídrik
thyme = tím
thy = thai
tibetters = tibeteres
tickled = tikled # el/le
tickles = tikles # el/le
tickle = tikel # el/le
tickling = tikling # el/le
tidal = taidal
tides = taides
tide = taid
tidied = taidied
tidings = taidinges
tidying = taidiing
tidy = taidi
tied = taied
tie = tai
tiftons = tiftones
tifton’s = tifton’s
tigers = tígres # er/re
tiger = tíger # er/re
tighte = tait
tignon = tinion
tiled = tailed
tiles = tailes
tile = tail
tiling = tailing
timbre = timber
timed = taimed
timeliness = taimliness
timelines = taimlínes
timeline = taimlín
timely = taimli
timer = taimer
times = taimes
time’s = taim’s
timetables = taimtábles # el/le
timetable = taimtábel # el/le
time = taim
timey = taimi
timings = taiminges
timing = taiming
timin = taimin
tines = taines
tine = tain
tiniest = tainiest
tintypes = tintípes
tiny = taini
tiptoed = tiptoued
tiptoeing = tiptouing
tiptoes = tiptoues
tiptoe = tiptou
tiredly = tairedli
tiredness = tairedness
tired = taired
tirelessly = tairlesli
tireless = tairless
tiresome = tairsum
tires = taires
tire = tair
tiring = tairing
titers = títres # er/re
titer = títer # er/re
tithian’s = tithian’s
tithian = tithian
titled = títled # el/le
title’s = titel’s # el/le
titles = títles # el/le
title = títel # el/le
titres = títres # er/re
titre = títer # er/re
tobin = toubin
today = todei
toenails = touneiles
toenail = touneil
toesie = touzi
toes = toues
toesy = tousi
toe = tou
together = together
togoland = tógoland
toink = toink
toi = toi
tokens = toukenes
token = touken
tole = toul
tolled = toled
tolling = toling
tolls = toles
toll = tol
toll = toul
tombs = tômes
tombstones = tômstounes
tombstone = tômstoun
tomcatting = tomkating
tomorrer = tomorer
tomorrow’ll = tomorou’l
tomorrow = tomorou
tongues = tunges
tonight = tonait
toorz = tôrz
toothache = tôth¬eik
toothcomb = tôth¬koum
toothmug = tôthmug
too = tô
topless = top¬less
topmost = top¬moust
toppled = topled # el/le
topple = topel # el/le
toppling = topling # el/le
torchlights = torch¬laites
torchlight = torch¬lait
toreador = toreador
torremolinos = toremolinos
torturemada = tortúrmada
torturin = tortúrin
totally = tótalli
toted = touted
totes = toutes
tote = tout
tothill = tot-hill
toting = touting
totin = totin
to = to
touché = tûshei
touchhole = tuchhól
touring = tûring
tourists = tûristes
tourist’s = tûrist’s
tourist = tûrist
touristy = tûristi
tournaments = tûrnamentes
tournament = tûrnament
tours = tûres
tour = tûr
tousle = tauzel # el/le
towards = towordes
toward = toword
towed = towed
toweled = taueled
toweling = taueling
towel = tauel
towing = towing
tows = towes
tow = tow
toyota = toyota
tracy = tráci
traded = treided
traders = treideres
trader’s = treider’s
trader = treider
trades = treides
trade = treid
trading = treiding
trainees = treinées
trainee = treiné
trainin = treinin
trance = trans
transferred = trans¬ferred
transferring = trans¬ferring
transfers = trans¬ferres
transfer = trans¬ferr
transgression = transgresion
transparency = transpárenci
transparent = transpárent
transportin = transportin
trapdoor = trapdor
tra = tra
traumatised = traúmatízed
traumatises = traúmatízes
traumatise = traúmatíz
traumatising = traúmatízing
traveled = traveled # el/le
travelers = traveleres # el/le
traveler = traveler # el/le
traveling = traveling # el/le
travelled = traveled # el/le
travellers = traveleres # el/le
traveller = traveler # el/le
travelling = traveling # el/le
travels = traveles # el/le
travel = travel # el/le
trays = treies
treacle = trykel # el/le
treason = trézon
treated = tréted
treating = tréting
treatments = trétmentes
treatment = trétment
treats = trétes
treat = trét
treaty = tréti
trees = tryes
tree = try
trekked = treked
trellissed = trelised
trembled = trembled # el/le
trembles = trembles # el/le
tremble = trembel # el/le
trembling = trembling # el/le
tricentenarians = trícentenarianes
tricentenarian = trícentenarian
tried = traied # ai\b
tries = traies # ai\b
triffic = trifik
trifled = trífled # el/le
trifles = trífles # el/le
trifle = trífel # el/le
trifling = traifling
trifling = trífling # el/le
trimension = trimension
trina’s = trina’s
trina = trina
trinder = trinder
triply = tripli
tristes = tristes
triumphalist = tríumfalist
triumphs = tríumfes
trixie’s = trixi’s
troubled = trubled # el/le
troublemakers = trubel¬meikeres # el/le
troublemaker = trubel¬meiker # el/le
troubles = trubles # el/le
trouble = trubel # el/le
troughs = trofes
trousseau = trôsó
truer = treuer
truest = treuest
true = treu
truly = treuli
truman = treuman
trundled = trundled # el/le
trundle = trundel # el/le
trundling = trundling # el/le
trustees = trustées
trustee = trusté
trustworthy = trustwerthi
truthfully = treuthfulli
truthful = treuthful
truths = treuthes
truth = treuth
trying = traing # ai\b
tryin = train # ai\b
try = trai # ai\b
ts = ts
tsvantoor = tsvantôr
tsvent = tsvent
’t = ’t
t = t
tuesdays = teues¬deies
tuesday = teues¬dei
tumbledown = tumbel¬daun
tumbled = tumbled # el/le
tumbles = tumbles # el/le
tumble = tumbel # el/le
tumbling = tumbling # el/le
tumpty = tumti
tum = tum
tunnelin = tunelin
turded = terded
turding = terding
turds = terdes
turd = terd
tureen = terén
turkeys = turkies
turkeys = turkies
turkey = turki
turne = turn
turpentined = turpentíned
turrets = turetes # ur-urr
turret = turet # ur-urr
turrible = turribel
turtles = turtles # el/le
turtle = turtel # el/le
tuslypa = tuslípa
tussaud’s = túsó’s
tussaud = túsó
tv = tv
twangingly = twangingli
t’wards = t’wordes
twen’y = twen’i
twice = twais
twinkled = twinkled # el/le
twinkles = twinkles # el/le
twinkle = twinkel # el/le
twinkling = twinkling # el/le
twirled = twerled
twirling = twer¬ling
twirls = twerles
twirl = twerl
twirl = twerl # eCC
twitchy = twichi
twixt = twikst
twopence = tupens
two = twô
tycoon = taikôn
tye = tai
tying = taing
tylers = taileres
tylers = taileres
tyler’s = tailer’s
tyler = tailer
typesettinge = típseting
typewriters = típ¬raiteres
typewriter = típ¬raiter
typhoon = taifûn
typos = típoes
typo = típo
tyrann = tíran
tz = ts
ubstitute = ubstitút
uccessful = ukcessful
uch = uch
ucket = uket
uck’s = uk’s
uck = uk
ucla = úkla
udden = uden
ueen = wén
uffin = ufin
ufos = ufoes
ufo = ufo
’uge = ’új
uge = új
uggest = ugest
uggs = uges
ugg = ug
uhnnhuhn = unnhun
uiet = uyt
uisance = usanc
ukraine = úkráin
ukrainian = úkráinian
ulp = ulp
umbriel = umbriel
unarmored = un¬armored
unashamedly = unasheimedli
unashamed = unasheimed
unassumed = unasúmed
unassumes = unasúmes
unassume = unasúm
unassuming = unasúming
unawares = unaweres
unaware = unawer
unbarred = unbared
unbarring = unbaring
unbeliev = un¬belyv
unbinded = unbainded
unbindes = unbaindes
unbinding = unbainding
unbind = unbaind
unblinkingly = unblinkingli
unblinking = unblinking
unbridled = unbraidled
unbroken = unbrouken
uncalculated = unkalkúláted
unceasingly = uncésingly
unceasing = uncésing
uncharred = unchared
unchosen = unchouzen
unch = unch
unclaimed = unklámed
unclenched = unklenched
unclenching = unklenching
unclipped = unkliped
uncoded = unkóded
uncombed = un¬koumed
unconcernedly = un¬kon¬cerned¬li
unconcerned = un¬kon¬cerned
uncowardly = un¬kauardli
uncurl = unkerl # eCC
undainty = un¬deinti
undefinable = undefínabel # el/le
undented = undented
undependable = undependabel # el/le
underclothes = underklouthes
underdoes = underdus
undergo = undergou
undershirts = under¬shertes
undershirt = under¬shert
undersize = undersaiz
understande = understand
understan = understan
underst = underst
undertaken = under¬teiken
undertakers = under¬teikeres
undertaker = under¬teiker
undertake = under¬teik
underworld = under¬werld
undeterred = undeterred
undeterring = undeterring
undeters = undeterres
undeter = undeterr
undirected = undírekted
undoes = undus
unearthly = unerthli
unearth = unerth
unease = unéz
uneasily = unézili
uneasy = unézi
un’er = un’er
unevenness = unyvenness
uneven = unyven
unfastened = unfasened
unfastening = unfasening
unfastens = unfasenes
unfasten = unfasen
unfood = unfôd
unfurl = unferl # eCC
’ungarian = ’ungarian
ungrip = un¬grip
ungulants = ungúlantes
unholy = unhouli
unhurried = unhuried
uninterested = uninterested
uninteresting = uninteresting
unkind = unkaind
unknowing = unknouing
unknown = un¬knoun
unladylike = un¬leidi¬laik
unleavened = unlevened
unless = unless
unleveled = unleveled
unlikely = unlaikli
unlike = unlaik
unlived = unlived
unluckiness = unlukiness
unmade = unmeid
unmakes = unmeikes
unmake = unmeik
unmaking = unmeiking
unmarried = unmaried
unmistakable = unmisteikabel # el/le
unmistakably = unmisteikabli
unnamed = unneimed
unnerved = unnerved
unnerves = unnerves
unnerve = unnerve
unnerving = unnerving
unny = uni
uno = ûno
unreadable = unrédabel
unreading = unréding
unreal = unréal
unreasonable = unrésonabel # el/le
unregarded = unregarded
unrelieved = unreléved
unrighteous = unrayteos
unripe = unraip
unriveted = unriveted
unrolled = unróled
unrolled = unrouled
unrolling = unróling
unrolls = unróles
unroll = unról
unruffled = unrufled
unruth = unreuth
unsafe = unseif
unscathed = unskeithed
unscrews = un¬skreues
unseamed = unsémed
unseaworthy = unséwerthi
unshakable = unsheikabel
unshaven = unsheiven
unslouching = unslauching
unsmiling = unsmailing
unsnapped = unsnaped
unspoken = unspouken
unsuccessfully = unsukcesfulli
unsuccessful = unsukcesful
’uns = ’unes
unsurely = unshúrli
unsureness = unshûrness
untidy = untaidi
untie = un¬tai
untimely = untaimli
untoe = unto
untoe = untou
unto = unto
untoward = untoword
untrademarked = untreidmarked
untrue = untreu
untruths = untreuthes
untruth = untreuth
untuned = untúned
untyl = until
unvanquished = unvanquished
unwavered = unweivered
unwavering = unweivering
unwavers = unweiveres
unwaver = unweiver
unwholesome = unhousum
upholdster = upholdster
upholstered = upoulstered
upholster = upoulster
upholstery = uphoulsteri
upon = upon
uppermost = uper¬moust
upright = up¬rayt
uprising = up¬raizing
upside = upsaid
upstairs = upsteires
upsy = upsi
up = up
urg = urg
’urt = ’urt
uruca = uruka
urucu = uruku
urved = urved
urv = urv
us2 = ús
use1 = ús
use2 = úz
uselessly = úslesli
useless = úsless
uses1 = úses
uses2 = úzes
uses = úzes
use = úz
usical = úzikal
usin = úzin
ussr = ússr
usually = úzúalli
ution = úcion
utmost = utmoust
uv = uv
uyghurs = uigures
uyghur = uigur
v1 = v1
vacations = vakáciones
vacation = vakácion
vacuum = vakúum
vade = vád
vagueness = vágness
valenians = valenians
valenian = valenian
valens’s = valenes’s
valens = valenes
values = valúes
vanbrugh = vanbrô
vangelder = vangelder
vanick’s = vanik’s
vanquished = vanquished
various = vários
vaughan = vaun
veal = vél
vegas = vegas
vegetables = vejetables # el/le
vegetable = vejetabel # el/le
veglia = velia
veg = veg
vehemence = véhemenc
venezuelan = venezuelan
verdant = verdant
verde = verde
verdict = verdikt
vere = vur
verge = verj
verminous = verminos # eCC
versions = verziones
version = verzion
veterinarians = veterinárianes
veterinarian = veterinárian
’ve = ’v
ve = vy
vfw = vfw
vice2 = více
victrola = viktrola
videotaped = videoteiped
videotapes = videoteipes
videotape = videoteip
videotaping = videoteiping
views = veues
viii = viii
vii = vii
vileness = vílness
villagers = vilajeres
villagers = vilajeres
villager = vilajer
villain = vilen
villainy’s = vileni’s
villainy = vileni
vill = vil
vincit = vincit
viricide = viricíd
virtues = virtúes
virtue = virtú
visine = vizin
vivaldi’s = vivaldi’s
vi = vi
vixens = viksenes
vixen = viksen
volunteered = voluntéred
volunteer = voluntér
vomity = vomiti
voodoun = vôdoun
voommmmm = vômmmmm
voo = vô
vorry = vori
vouchsafed = vauch¬seifed
vouchsafes = vauch¬seifes
vouchsafe = vauch¬seif
vouchsafing = vauch¬seifing
vould = vûd
vows = vaues
vroooom = vrôôôm
vroooosh = vrôôôsh
vrooosh = vrôôsh
’v = ’v
v = v
wabble = wobel # el/le
waded = weided
wade = weid
wafers = weiferes
wafer = wáfer
wafer = weifer
waged = weijed
wages = weijes
wage = weij
waggled = wagled # el/le
waggle = wagel # el/le
waggling = wagling # el/le
waging = weijing
wailed = weyled
wailing = weyling
wails = weyles
wail = weyl
waistcoats = weystkoutes
waistcoat = weystkout
waist = weyst
wakefulness = weikfulness
wakeful = weikful
wakened = weikened
wakening = weikening
wakens = weikenes
waken = weiken
wakes = weikes
wake = weik
waking = weiking
walesburg = weilesburg
walkin = wookin
walks = wookes
walleyed = wolayed
wallowin = wolouin
wal = wal
wame = weim
wampeters = wampeteres
wampeter = wampeter
waned = weined
wanes = weines
wane = wein
waning = weining
wardour = wordor
warehouses = weirhauses
warehouse = weirhaus
ware = weir
warily = weirili
warlike = worlaik
war’ll = wor’l
wars = wores
wartime = wor¬taim
war = wor
wary = weiri
wary = weiri
wasabi’s = wasabi’s
wasabi = wasabi
wasn’t = woz’nt
wasted = weisted
wasteland = weistland
wastes = weistes
waste = weist
wasting = weisting
wastin = weistin
wa’s = wa’s
was = woz
watchin = wochin
waterside = wotersaid
waterworks = woterwerkes
waterwork = woterwerk
watts = wottes
watt = wott
waved = weived
wavelengths = weivlengthes
wavelength = weivelength
wavelength = weivlength
wavelets = weivletes
wavelet = weivlet
wavered = weivered
wavering = weivering
wavers = weiveres
waver = weiver
waves = weives
wave = weiv
waving = weiving
wavy = weivi
wa = wa
waxed = waksed
waxes = wakses
waxing = waksing
wax = waks
waxworks = wakswerkes
waxwork = wakswerk
ways = weies
’way = ’wei
wazzock = wazok
weakened = wékened
weakening = wékening
weakens = wékenes
weaken = wéken
weakling = wékling
weak = wék
weaponized = weponízed
weaponizing = weponízing
wearers = weireres
wearer = weirer
wearing = weiring
wearin = weirin
wears = weires
wear = weir
wednesdays = wenesdeies
wednesday = wenesdei
we’d = wy’d
weeell = wyyl
weeks = wykes
week = wyk
weel = wyl
weensy = wynzi
wehrmacht = vermaht
weighed = weyed
weighing = weying
weighs = weyes
weights = weytes
weight = weyt
weigh = wey
weirdness = wyrdness
weird = wyrd
weishaupt’s = waishaupt’s
welcomed = wel¬kumed
welcomes = wel¬kumes
welcome = wel¬kum
welcoming = wel¬kuming
we’ll = wy’l
welsh = welsh
we’m = wy’m
wensleydale’s = weneslideil’s
wensleydale = weneslideil
wensley’s = wenesli’s
wensley = wenesli
were1 = wer
weren’t = wur’nt
weretoads = wer¬toudes
weretoad = wer¬toud
werewolf = wer¬wûlf
werewolves = wer¬wûlves
were = wur
we’re = wy’r
we’s = wy’s
we’uns = wy’unes
we’ve = wy’v
we = wy
whaeeeeeeeee = waiiiiiiiii
whalebone = weilboun
whalers = weileres
whaler = weiler
whalesong = weilsong
whales = weiles
whale = weil
whaling = weiling
whammed = wamed
whap = wap
whar’s = war’s
whar = war
whatnots = wotnotes
what’s = wot’s
whatta = wata
what’ve = wot’v
wha = wa
wheedled = wydled
wheee = wyyy
wheelbarrows = wyl¬baroues
wheelbarrow = wyl¬barou
wheeps = wypes
wheep = wyp
whee = wyy
wheles = weles
whenever = wen¬ever
whene = wen
whereases = werazes
whereas = weraz
wheresoever = wer¬sou¬ever
where’s = wer’s
Whereupon = wer¬upon
where’ve = wer’v
where’ve = wer’ve
whe = we
whew = weu
whichaway = wichawei
whifflecattin = wifelkatin # el/le
while = wail
whilst = wailst
whined = wained
whines = waines
whine = wain
whiney = waini
whining = waining
whining = waining
whiny = waini
whippin = wipin
whipsnade = wipsneid
whirled = werled # eCC
whirling = werling # eCC
whirls = werles # eCC
whirl = werl # eCC
whirred = wured
whirring = wuring
whirrs = wures
whirr = wur
whir = werr
whistled = wisled # el/le
whistles = wisles # el/le
whistle = wisel # el/le
whistling = wisling # el/le
whitechapel = waitchapel
whitehall = wait-hol
whitely = waitli
whitened = waitened
whiteness = waitness
whitening = waitening
whitens = waitenes
whiten = waiten
whiter = waiter
whites = waites
white = wait
whitewashed = waitwoshed
whitewashes = waitwoshes
whitewashing = waitwoshing
whitewash = waitwosh
whizzle = wizel
who’d = hô’d
whoever = hôever
who = hô
wholehearted = houlharted
wholeheartedly = houlhartedli
whole = houl
wholesale = houlseil
wholesales = houlseiles
wholesome = houlsum
wholly = houlli
whom = hôm
whoomph = wômf
whoom = wôm
whooo = wôô
whooshing = wôshing
whooshshshsh = hôshhhh
whoo = wô
whorl = werl # eCC
whose = hôz
who’s = hô’s
whurrizee = wurrizy
whut’d = wut’d
whut’s = wut’s
whut = wut
wh = w
why’n’t = wai’n’t
why’re = wai’r
whyteleafe = waitlyf
why’ve = wai’v
wicked1 = wikied
wicked2 = wiked
wicked = wikied
wicklin = wiklin
widdowe = widou
widely = waidli
wide = waid
wif = wif
wiggled = wigled # el/le
wiggles = wigles # el/le
wiggle = wigel # el/le
wiggling = wigling # el/le
wih = wi
wii = wii
wilburys = wilberies
wildlife = waild¬laif
willowfine = wiloufín
wimmen = wimen
wimmin’s = wimin’s
wimmin = wimin
wimple = wimpel # el/le
wind1 = wind # blowing
wind2 = waind # turing coils
windbright = windbrait
winded1 = winded # blowing
winded2 = wainded # turing coils
winded = wainded
winding1 = winding # blowing
winding2 = wainding # turing coils
winding = wainding
windin = windin
windows = windoues
winds1 = windes # blowing
winds2 = waindes # turing coils
windscale = windskeil
winds = windes
wind = wind
wineskin = wínskin
wines = wínes # vs whines
wine’s = wín’s
wine’s = wín’s
wine = wín # vs whine
winfield’s = winfyld’s
winfield = winfyld
wingtip = wingtip
winsun = winsun
witchcraft = witchkraft
witchcrafty = witchkrafti
witches = witches
witchfinders = witchfainderes
witchfinder’s = witchfainder’s
witchfinder = witchfainder
witchfinding = witchfainding
witching = witching
witch = witch
withdrawed = withdrooed
withdrawing = withdrooing
withdrawn = withdroon
withdraws = withdrooes
withdraw = withdroo
without = with¬aut
wittering = witering
wivving = wiving
wiv = wiv
wi = wi
wizzsh = wizsh
wodge = wodj
woebegone = woubegon
woken = wouken
woke = wouk
woman = wûman
women = wimen
wonderin = wunderin
wonne = wun
wonter = wuntur
won’t = wou’nt
woodbine = wûdbain
wooden = wôden
woods = wôdes
woodsy = wôdsi
wood = wôd
woolwich = wûlij
worded = werded # eCC
wordes = werdes
wordings = werdinges # eCC
wording = werding # eCC
wordlessly = werd¬les¬li
wordless = werd¬less
words = werdes # eCC
word’s = werd’s # eCC
word = werd # eCC
wore = wour
workaholics = werkaholikes
worked = werked # eCC
workers = werkeres # eCC
worker = werker # eCC
workeshoppe = werkshop
workhouse = werkhaus
workings = werkinges
working = werking # eCC
workin = wurkin
workloads = werkloudes
workload = werkloud
workplace = werkplác
works = werkes # eCC
work = werk # eCC
worlde = werld
worldly = werldli
worlds = werldes # eCC
world’s = werld’s # eCC
world = werld # eCC
worldwide = werld¬waid
wormholes = wermhóles # eCC
wormhole = wermhól # eCC
worms = wermes # eCC
worm = werm # eCC
wormwood’s = wermwûd’s
wormwood = wermwûd
worriedly = wuriedli
worried = wuried
worriers = wurieres
worrier = wurier
worries = wuries
worrying = wuriing
worryin = wuriin
worry = wuri
worse’n = wers’n
worse = wers # eCC
worshiped = wershiped
worshipers = wershiperes
worshiper = wershiper
worshiping = wershiping
worshipin = wershipin
worshipped = wershiped
worshipping = wershiping
worships = wershipes
worship = wership
worst = werst # eCC
wors = wurs
worthless = werthless # eCC
worth = werth
worth = werth # eCC
worthwhile = werthwail
worthwhile = werthwail # eCC
worthy = werthi
wosies = wouzies
wossat = wosat
wossit = wosit
woss = wos
wo’th = wo’th
wotling’s = wotling’s
wot’re = wot’r
wot’s = wot’s
wott’re = wot’r
woulda = wûda
wouldna = wûdna
wouldn’t = wûd’nt
wouldn = wûdn
wound1 = wônd
wound2 = waund
wowwowwow = wauwauwau
wpa = wpa
wrang’s = rang’s
wrestled = resled # el/le
wrestle = resel # el/le
wrestler = resler # el/le
wrestlers = resleres # el/le
wrestling = resling # el/le
wriggled = rigled # el/le
wriggle = rigel # el/le
wriggles = rigles # el/le
wriggling = rigling # el/le
wrinkle = rinkel # el/le
wrinkles = rinkles # el/le
wrinkly = rinkli # el/le
write = rait
writer = raiter
writers = raiteres
writes = raites
writhed = raithed
writhe = raith
writhes = raithes
writhing = raithing
writinge = raiting
writing = raiting
wronge = rong
wrote = rout
wryly = raili
wud = wûd
wuh = wu
wuk = wuk
wumman = wuman
wun’t = wu’nt
wuv = wuv
’w = ’w
w = w
www = www
wynd = wind
wyoming = wai¬ouming
wytch = witch
xanti = shanti
xiii = xiii
xii = xii
xinjiang’s = xinjiang’s
xinjiang = xinjiang
xiv = xiv
xi = xi
xix = xix
xo = xo
xviii = xviii
xvii = xvii
xvi = xvi
xv = xv
x = x
xxi = xxi
xxxv = xxxv
xx = xx
yachts = yotes
yacht = yot
y’ain’t = y’ei’nt
yale = yeil
yankees = yankyes
yara = yara
y’are = y’ar
yarring = yaring
yawl = yool
yawned = yooned
yawning = yooning
yawns = yoones
yawn = yoon
yazhno = yazhno
yaz’ll = yaz’l
yazoo = yazô
yaz’s = yaz’s
yaz = yaz
yearlings = yirlinges
yearling = yirling
yearned = yerned
yearningly = yéringli
yearning = yerning
yearns = yernes
yearn = yern
years = yires
year = yir
yeasts = yéstes
yeast = yést
yeeara = yéara
yeff = yef
ye’ll = yé’l
yenk = yenk
yeoman = youman
yeomen = youmen
yera = yera
ye’re = yé’r
yerself = yorself
yessir = yes¬sur
yessum = yesum
yetis = yeties
yette = yet
yeux = yeux
yews = yeues
yew = yeu
yielded = yélded
yielding = yélding
yield = yéld
yihe = yihe
yngemina = íngemina
yodels = yódles
yolk = youlk
yo’self = yo’self
yos = yos
you’d = yô’d
youf = yôf
you’ll = yô’l
young’uns = yung’unes
you’re = yo’r
youre = yor
your’n = yor’n
yourself = yorself
yourselves = yor¬selves
yours = yores
you’r = yo’r
your = yor
yous = yôes
yous = yôes
you’s = yô’s
youtube = yôtúb
you’ve = yô’v
you = yô
yowe = yô
yo = you
yoze = yoze
yphoon = ífûn
ypres = iper
’ysterica = ’isterika
ysterical = isterikal
ythological = itholojikal
yt = it
yuch = yuch
yulefest = yôl¬fest
yules = yôles
yuletide = yôl¬taid
yule = yôl
y = y
zah = zaa
zamoo = zamô
zat = zat
zay = zei
za = za
zemla = zemla
zem = zem
zere = zer
zese = zyz
zhap = zhap
zhip = zhip
zinka’s = zinka’s
zinka = zinka
zipt = zipt
ziraphale = zirafál
zis = zis
zoereed = zoereed
zoological = zóolojikal
zoren = zoren
zo = zo
zuigiber = zuigiber
zululand = zûlu¬land
zut = zut
zymologist = zímolojist
zymology = zímoloji
zymoveal = zímo¬vél
z = z
zzap = zzap

# ZZZ. á é í ó ô ú û ¬ ’
